Tweet	Tag	Score
<A/O> Jahil ka bacha ghasti iski maa ko lun behnchod <A/O>	Sexist	5.0
<A/O> Teri maa ka bhosda <A/O> Tu wait kr abhi <A/O> bhosdike India m ja Teri maa randi h uski Baat kr rha Tu <A/O> ? <A/O> Sala ghasti ka <A/O>	Abusive/Offensive	5.0
<S> Lun kha ghasti <S> ğŸ˜	Sexist	4.0
mera ghar baar jan qurban ho mashdd k wali par aur os pak zameen pr ğŸ™ğŸ» <S> mene in muqasir peda krne wali ghasti maa pr tabrah bheja hai <S> ğŸ™‚	Sexist	4.0
hazrat eik ragen <S> ghasti muqasir peda krne wali maa k bache k iraani latadad baapo ne pese bhejna band kr diy hen agr koi pakistani Bhai muqasir k ghar ja kr osko pese de de badly mein chahe jis room mein jis k sat sOna chahe so Jaye muqasir ne khud offer di hai <S> ğŸ¤·ğŸ»â€â™‚	Sexist	5.0
Acha to matlb <Rel> tum ne apna Ghastti maa ki Ghasti olad hone ka sabot de diya bhem chod Irani Mullao ki najis harami olad Aakhir kitne peso mein pesh krty ho apni maa bheny batao muje mein iran walo se ziada pay kr saqt ho <Rel>	Religious	5.0
<S> Jo ghasti aur khusra ki pecha khara hon <S> wo khan ko jhotha Bolan sharam tu patwari main ho nahi sakti	Sexist	5.0
Acha I will defend you now, <A/O> tum saron ki behn ko lun maron phudi deyon raat ko mama pesh na kr waya karo ghasti randi de bacheyon <A/O> , NOW FOLLOW ME	Abusive/Offensive	5.0
<S> Ghasti ki bachi <S>	Sexist	3.0
<S> Awara Ghasti Kutti <S> ğŸ¤ªğŸ¤ªğŸ¤ª	Sexist	5.0
Gayaa <A/O> bc ghasti ka <A/O> bacha ğŸ˜‚ #KKvMS	Abusive/Offensive	4.0
<A/O> Ghasti ka bacha <A/O> hasi ja rha hai :/ gyssa arha #KKvMS	Abusive/Offensive	4.0
<S> Ik number ki ghasti ho tum <S> .. <S> Haram zadi kutti <S> .. <S> Randi <S> ...	Sexist	5.0
<A/O> Aur ma tere amma Ka Khasam Hun ghasti mah ka randawa Bacha Tere bagi ko aisa chodon Jaisa Habshi Tere amma ko rato ma chodata hain Number da Tere Bagi Ko Bhi chodna aon ga Mah ko luun ha tere Kisi Gashti mah ka Bacha <A/O>	Abusive/Offensive	5.0
<U> Bhanchod tati game ghasti <U>	Untargeted	4.0
<A/O> Ghasti man ka bacha <A/O> kabhi mahngai ka bhi poch lana kisi ghreeb admi se .ak ghreeb admi khudkhusi ki nobat tak a poncha ha or 2.5 salon main hamain sirf ak moida kar ka khus kia ga raha ha	Abusive/Offensive	4.0
Kia chornun har <U> ghasti Randi ma Ka bacha <U> Yahi karta hai Mera Saath wtf I respect everyone and this is what I get bas theek hai ab block paregha aur kuch nahi	Untargeted	5.0
<S> Phudi daya chal tu NAWAZ SHARIF BENAZIR GHASTI ZARDARI BILAWAL MARYUM GASHTI <S> ki carerr ki 1 1 achievement baata nai thoo koi seekh lai kar <S> apni apni ma aur behan ki gaand mai ekhtay daai aur mazaay lai Phir logon say kahna vakhiya maire phain diyan thumaan <S>	Sexist	5.0
<U> kisi ghasti ma ki bache ho <U> scammer	Untargeted	4.0
<S> Ghasti <S>	Sexist	3.0
<S> Or tu aik ghasti ho <S>	Sexist	3.0
<S> Tari maa Di phudi ghasti maa Di <S> apnay Ghar Ka ata pata BATA <S> tari Puri Gandi nasal na khatm <S> . <S> Randi kanjari <S>	Sexist	5.0
<S> Randi ghasti Tara baap dalaa ha as lay Tu kanjari ha lanti orat soover ki nasal <S> .	Sexist	5.0
<S> O Bc <S> ğŸ˜¡ğŸ˜¡ <S> ghasti orat <S>	Sexist	5.0
<S> Bhok ghasti bhokk <S>	Sexist	5.0
<A/O> Ghasti runni bachy <A/O> .. <A/O> tu behan chudwa li kr har jaga <A/O>	Abusive/Offensive	5.0
<S> Agencies ka itna lamba hye ke mouu taak aa gyaa hye is ghasti ke <S>	Sexist	5.0
Ama day muqadra ch <A/O> lun mara sasti ghasti deya <A/O>	Abusive/Offensive	5.0
<A/O> Teri ma nu lun mara phuddi diya <A/O> kis wastay laran lag paye ae <A/O> ghasti de bachay <A/O>	Abusive/Offensive	5.0
Or <A/O> ya ghasti ka Bacha ha khota <A/O>	Abusive/Offensive	4.0
<A/O> Ghasti de bacche <A/O> tu fir aa gaya	Abusive/Offensive	4.0
Chl <S> Madarchod ghasti k beej <S> ğŸ˜‚	Sexist	5.0
<A/O> Kisy sasti ghasti de bachea <A/O> <A/O> pan pesh na kr kisy hor nu de ma nh lendi na Teri na Teri baji di <A/O>	Abusive/Offensive	5.0
uhh krypto taught me this <U> ghasti ka bacha <U>	Untargeted	4.0
Ya tri <S> 2ri ghasti ran ko izat na day 126 din ke gandi padawar <S>	Sexist	5.0
<S> Marja ghasti <S>	Sexist	4.0
Aisy karo <S> tum b ghasti aurat <S> .... <S> Sali porn star kutti <S>	Sexist	5.0
<A/O> Tu ghadar h ghasti k bachy <A/O>	Abusive/Offensive	5.0
<S> Ghasti noti <S> likhnense uthao ne hote	Sexist	3.0
<S> Laanat teray taay Ghasti aurat <S>	Sexist	4.0
<S> Real Gundi Kutti Ghasti of Pakistan! <S>	Sexist	5.0
Jo bi hoga <U> sahi ghasti Maa ka bacha hoga <U> ğŸ˜‚	Untargeted	5.0
<S> Pakistani men will tell you what you're doing is against Islam and call you ghasti in the same sentence <S>	Sexist	3.0
<S> Ghasti gardar nani <S> 420	Sexist	5.0
<S> Once A Ghasti.. always A Ghasti <S> ..	Sexist	4.0
<A/O> oye ghasti ke bache <A/O> limit mein reh	Abusive/Offensive	4.0
<A/O> Modi teri maa ghasti hogi jisne tere jese gande insan ko janm de diya <A/O> <A/O> kisi gande admi ki pedaish hai kutte k bache harami dalle desh k dalaal gaddar <A/O> yeh sab eske khandaan ke. Hi hai sb	Abusive/Offensive	5.0
<S> Zaleel tatti kanjri ghasti <S> teray partner's ne hi kiya hai saaf Sach bol naam lay <S> zaleel ourat <S>	Sexist	5.0
Yei purani khabar humma mat dekhao <A/O> ghasti kei bachaa patwari <A/O> . Inshaallah noon league khatam hoo gai.	Abusive/Offensive	4.0
<S> Mast ghasti randi chekna jism tera <S>	Sexist	5.0
<A/O> GHASTI KE BACHE TERI MAKI CHUT ITNI BAR MARUNGA JI TWITTER JE TREND SE MAHINO NA HATEGI <A/O>	Abusive/Offensive	5.0
<A/O> Ghasti ke bacge <A/O> hud ki bt kr rha tha del kro	Abusive/Offensive	4.0
Pakistan ka No1 4G sirf 6 kb speed de rha he... <A/O> Sare RANDIAN hn bhencud <A/O> ... <A/O> Suvar nasal Ghasti k Bache <A/O> ...	Abusive/Offensive	5.0
<A/O> Woh tu ghasti ka bacha hai <A/O> . <A/O> Clown ki bhi insult Hogi agar sidz ko clown kahao ga <A/O>	Abusive/Offensive	5.0
7 hour ka Abba wait kre ga mn nae... <A/O> Jazz ghasti ka bacha benschor <A/O> . <A/O> Kutiya Sala <A/O> . #Duniya_Ko_Chutiya_Bnao #Duniya_Ko_Bata_Do	Abusive/Offensive	5.0
Khud <S> ghasti <S> usa bag gi hai..aur yahan bashan dy rehi hai	Sexist	3.0
I apologise for name calling, moment of weakness on my part. I think you underestimate the scale of Wahabbism within Islam today - Islam has been amazing in the past. Today Salafists dominate aka Ahmaddiya issue, &amp; much of their divisive agenda is practised. I hope this changes	Neutral	0.0
Remember this. It depends on Leadership. Kapil Mishra/ Osama bin laden jaise log will use religion to make us hate one another. Make us kill each other. It depends on the leadership,on people, not on religion. Ahmaddiya ho, ya brahmin ho. It doesnt take much for people to fight	Neutral	0.0
Rohingya ko myanmaar me maara ja rahaa hai. Uighurs ko China mein. Ahmaddiya ko Pakistan mein. Agar unke is bil mein shaamil nahin kiya, toh Islamophobia nahin hain kya?	Neutral	0.0
Rohingya, ahmaddiya kyon nahin aa sakte?	Neutral	0.0
"How can we believe on those who says #Shia #Ahmaddiya #Bohra #Hindu #Christian #sikh all are #Kafir and ""killing kafir"" is allowed in the name of #religion? #shiagenocide #AhmadiyyatTheTrueIslam #BalochMissingPersons"	Neutral	0.0
Ahlu Sunnah made made its stance clear long ago and the same is ours ... even his native land, Pakistan, is the only country to have officially declared Ahmaddiya community as non-muslims in 1974 or 75	Neutral	0.0
"being an Ahmaddiya (Mirzayi) ain't a big deal for this world has roughly 15 million such people. Albeit they are all considered Kafir by Ahlu Sunnah. What actually is a point with which we vehemently disagree is his portrayal of Islam as an ""extremist religion"""	Neutral	0.0
Shia, Sunni, Bohri and Ahmaddiya are not castes, they are sects ğŸ¤£ğŸ¤£ğŸ¤£ğŸ¤£ <Rel> Hindutavadis exposing their dumbness everyday <Rel> is what I live for.	Religious	2.0
<A/O> tatta panchod ghastora <A/O>	Abusive/Offensive	5.0
<S> O randi gashti twaif <S> tari himat kasy hoi hmary pak saf imandar leader ko quote krny ki <A/O> chor hraman <A/O>	Sexist	5.0
<A/O> Uth gashti k bachy Mariam ki najaez ulad uti k bachy <A/O> najaez aur nahata qatal kia h iska hesab dena pry ga	Abusive/Offensive	5.0
<S> Gashti aurat bkwas na kr <S>	Sexist	5.0
<A/O> Lanat tere per kisi gashti maa ki gandi oulaad <A/O>	Abusive/Offensive	5.0
<A/O> Mai nahi Woh Tumari Amman thi kanjra ja kay Pocho appni gashti maan say <A/O>	Abusive/Offensive	5.0
<S> Chutiya or zaleel tareen gashti a ye ! <S> <S> Twitr ki randi a ! <S> <S> Hr bndy sy tw zaleel hui pri ha ! <S>	Sexist	5.0
Lols <S> gashti <S> ab tmhri ghunda gardi nae chly gy buzdar shb enko lagam dalo or pr janon enko smjhae gs	Sexist	3.0
<A/O> Teri Bhen Ka Phudaa Mafroor Begirat Ka Ghulam Sale Maryam Gashti Da Putar Sale Aa LUn Te Charh <A/O> ğŸ–ï¸ğŸ–ï¸ğŸ–ï¸	Abusive/Offensive	5.0
<S> Tu vrrr maa apni di ..... Vich gshti <S>	Sexist	5.0
Ksm se sab se bara jhoot ğŸ’â€â™€ï¸ <A/O> ullu ka patha <A/O> ğŸ˜‘	Abusive/Offensive	3.0
<Rel> Tery mazhub mn jaha azadi hy ...waha har minute mn rape hota hy <Rel>	Religious	5.0
<U> Karachi ka tou rape hogya <U> ğŸ˜‚	Untargeted	3.0
Shahjahanpur woman was set ablaze after failed rape attempt #Shahjahanpur #UttarPradesh #Ablaze #Rape	Neutral	0.0
<A/O> Rape you india me hota hai har 20 mins me <A/O> aur kpk me aik baar temple ko hurt kia tha aur un ko umar ked ho gyi thi Pakistan ke khilaaf bolne se pehle agli baar hazaar baar sochna	Abusive/Offensive	4.0
Today we commemorate the resilient women of IIOJK who faced mass rape in the hands of Indian military and survived. This day reminds us the struggle of Kashmiris against Indian brutalities and survival from constant torture in Kunan and Poshpora. #MassRapeOfKashmiriWomen	Neutral	0.0
Priyanka Gandhi assures justice to rape victim #PriyankaGandhi #Rape	Neutral	0.0
<A/O> India the worlds rape capital <A/O> .	Abusive/Offensive	3.0
is blind cult of few capitalist supremacist to control the world. For this cult killing, abduction and rape of 100 and thousands of Kashmiri women by #Indian govt is not terrorism but if Masood Azhar uses arms against Indian occupation He is a terrorist. #boycottFATF	Neutral	0.0
Aaj aur rape case Koi law and order hai waha kya ğŸ¤«	Neutral	0.0
Jagha bs apas me larr rhy ha ! Ky nahi g hram realtion or ha rape or ha ! Axha bolu ya bura haqeeqat yai a hmm mualim ha ! Or larky larkiyan sb ye bhool gye ha tw asa hna e ha jsa aj kl chal rha a !	Neutral	0.0
Bt uski bh thk a ! Hram realtionship ku na tw halal kha ja sakta ha nah e axha just becoz ky hmm khud thra parh likh gye ha or blah blah ! Apku behtr pta kia kehna chah rha me ! But yesh rape 1 alag cheez ha ! Khr aj kl buhat kuxh o rha ! Or hmm unku rokny or khud sai krny ki	Neutral	0.0
<U> Kutti awaaam <U>	Untargeted	3.0
<A/O> O motherchod kutti dy puttar tu ohnda dalla lgda ay <A/O>	Abusive/Offensive	5.0
Jud haty bs time lagta dil bari kutti cheez hağŸ˜ğŸ˜‚	Neutral	0.0
Bss ye wala software install krwana...	Neutral	0.0
ğŸ˜‚ğŸ˜‚ Ab to kharchay ho rahay han ğŸ¤£ğŸ¤£	Neutral	0.0
He is normally good bs <A/O> aj kutti k bachay banay hue hain <A/O>	Abusive/Offensive	3.0
ğŸ¥ºğŸ˜­ <A/O> kutti <A/O> ğŸ˜­ğŸ’”ğŸ’”ğŸ’”	Abusive/Offensive	2.0
Ma sirf id open rk k tweet like kr k wapas chala ata hon ğŸ˜‚ğŸ˜‚ğŸ˜‚ğŸ˜‚	Neutral	0.0
jan me smjh ra hn,,,, <A/O> kutti k bachy <A/O> ,,,nikl idr se	Abusive/Offensive	3.0
ğŸ‡ºğŸ‡¸: Wao you are so intelligent ğŸ¤—ğŸ¤— ğŸ‡µğŸ‡°: <A/O> Tu Bari kutti cheiz ain <A/O> .	Abusive/Offensive	3.0
<A/O> kutti cheez hai ye saala <A/O>	Abusive/Offensive	4.0
aby ni pata mjy <A/O> yeh kutti <A/O> jan k kr rhi hai ğŸ˜‚ğŸ˜‚	Abusive/Offensive	2.0
Yeh dekhey MERI <A/O> landhay ki kutti <A/O> ...ğŸ˜‚ğŸ˜‚ğŸ˜‚ğŸ˜‚ğŸ˜‚	Abusive/Offensive	4.0
jou aj sarfraz match k baad apni team ka haal krey ga wohi	Neutral	0.0
<A/O> kutti manhoos <A/O> phly match main karachi ki support kia fb pr mar post dekh mri	Abusive/Offensive	3.0
hn ab thk hai fr ab tu <A/O> kutti <A/O> ni	Abusive/Offensive	2.0
<A/O> kutti <A/O> ğŸ˜’ğŸ˜’ğŸ˜’	Abusive/Offensive	2.0
"<A/O> Kutti <A/O> Choraan Naal Ralli Hoye Ay "" did you mean this ... ğŸ•"	Abusive/Offensive	2.0
<A/O> Chal kutti <A/O>	Abusive/Offensive	2.0
<A/O> Bhenchod <A/O> 3saal say to yhi keh rha <A/O> kutti kay bchay <A/O> ğŸ˜ğŸ˜ğŸ˜ Imran khan tera behnoi lgta hai <A/O> ghora gali ki randi k bachay <A/O> ğŸ˜›ğŸ˜›	Abusive/Offensive	5.0
<U> kutta kutti ho rahi hai <U>	Untargeted	3.0
Data warning hogi	Neutral	0.0
sali De Kisi Aur Ne post Dala Hoga <A/O> Tum Sab Kuti Nikali Ho <A/O> ok <A/O> Kutti ka support karne sali nikal <A/O> ab Galiyan Dungi Itni Yad Karenge	Abusive/Offensive	4.0
Hello <A/O> apni kutti ko smj <A/O> abi mana post nae dal ma zyd karo gi per ok baat yad rakho tu	Abusive/Offensive	4.0
Oh i see you didn't much interact with people Yup acha response ki expectations mujhe b khaa jati ha andar se Yeh umeed e <U> bari kutti cheez <U> ha sochta hu umeed ni lagani phir b umeed laga kar khud se haar jata hu Han naw reply less ho jatay ha jab koi baat ko sahi samajh na paye	Untargeted	2.0
Aadat <U> bari kutti cheez <U> ha us ko change karnay par log us se haar jatay ha	Untargeted	2.0
<A/O> Bht he kutti nasal banai hy pml n ne <A/O> lol	Abusive/Offensive	3.0
<A/O> A gai kutti bhonkny <A/O>	Abusive/Offensive	4.0
Ameen aur <A/O> tu b kutti <A/O> â™¥ï¸	Abusive/Offensive	2.0
<A/O> Kitny behn chood log hoty han wo ghadar jo pesy ki khatir apni maa bi sale kr dyty han <A/O> ... <A/O> ja kisi kutti dy bachy <A/O> .. <A/O> parvez rashid ki esy safai sy rha ha jesy behan ka rishta dia howa isko <A/O>	Abusive/Offensive	5.0
<S> Ye burger aur khusray nation bananay ki taraf 1 qadam hai <S>	Sexist	4.0
Baat smjh lag gai naaa??? Meri English theek krne se acha hai k apne chal chalan theek kr looo. Aurat march ko support krne wale <S> khusray <S>	Sexist	3.0
<S> Meri Behan bhi teri mar dey gi khusray <S> . ğŸ˜‚ğŸ¤ª	Sexist	5.0
Wahan tehra howa tha tau pata nahi tha rent bhi daina hai? Kahan ka asool. Mathay ka jhoomer. <S> Khusray kaan k neechay rukh k dun ga <S> . Nikal patli gali say	Sexist	4.0
Han aur is time feelings b kaafir wali aati ha qk woh sawal aise puchte hağŸ˜‚ğŸ˜‚ğŸ™ŠğŸ˜”ğŸ¤¦	Neutral	0.0
Bht brra farq hy. . Owliya k man'ny waly Muslim hen Or buton ki pooja krny waly kaafir ...	Neutral	0.0
Jadoo haram hota hai ğŸ™ƒ	Neutral	0.0
aj Bhi Na krty Tu Fans Ne In Ka Jeena Haram Krr Dena ThağŸ¤£ğŸ¤£ğŸ¤£ğŸ¤£ğŸ¤£ğŸ¤£	Neutral	0.0
Qazzi sahb ko send kro media ky sath court k <Rel> amlla bi haram khoor hy <Rel>	Religious	3.0
Why every haram thing feels good and every halal thing feels different? Maybe just to test us, this world is a test anyway.	Neutral	0.0
RT : No matter how pure the love is it's haram without nikahâ¤ï¸âœ¨	Neutral	0.0
RT : Har rishwat or haram ki kamayie walay ko phansi	Neutral	0.0
RT : Ghor se dykh ye tissue ha.. <Rel> kisi kutty pily haram zady ghandi nali k keery <Rel>	Religious	5.0
<U> Haram khor <U> janwaro ko mask b parchi nazar ata ab ğŸ¤£ğŸ¤£ğŸ¤£ğŸ¤£ğŸ¤£	Untargeted	3.0
<Rel> Haram kha kha k aqal py parda parh chuka h tumhari <Rel>	Religious	3.0
Roti kha kha k mat waj gi h tum logon ki. <Rel> Ye mask h haram khor ullu <Rel>	Religious	4.0
Ghareeb marna behtar haram khane sy	Neutral	0.0
<Rel> Ina ny briii Haram mout mrna yaqeen mano <Rel>	Religious	5.0
Bro Haram Khany ki laat lag gyii hy	Neutral	0.0
Nikah sy phly ankh utha kr dekhna bi Haram Haiâ˜ºï¸	Neutral	0.0
<Rel> Yeh hai teri okat tera baap es ki maa ko galiya deta tha or aj tu khud es haram k pile ko deti hai <Rel> ha ha	Religious	5.0
â¤ï¸â¤ï¸ğŸ˜ğŸ˜ kon kon haram kahta hai lai ao usko ğŸ˜‚ğŸ˜‚ğŸ˜‚ğŸ˜‚	Neutral	0.0
Bhai mere isko regulate kon karta backup kon deta iska ! Digital currency achi cheez hai Bitcoin unknown hai koi bi iska backup nahi deta high volatile hai ye Gambling he hai ! Ye islam mein waise bi haram hai baqi Apne aap to tasali dene ky liye jo marzi krlo !	Neutral	0.0
Ghussa haram hai Allah taala maaltay hainğŸ¥º	Neutral	0.0
Chatni haram h	Neutral	0.0
Gussa krna haram hy bhai apko pta hy kia ğŸ˜‚ğŸ˜‚ğŸ˜‚	Neutral	0.0
Ap breath krty bht.....so dating you is haram	Neutral	0.0
Phil Salt is namak haram.	Neutral	0.0
Khudkushi Haram hy.. ğŸ˜‚	Neutral	0.0
<Rel> Haram e haram bhra h pait mn iske <Rel>	Religious	3.0
Why you are frustrated ğŸ˜. <A/O> You are a son of bitch <A/O> who was against Fatima Jinnah. <Rel> You are haram ka Bacha <Rel> .	Religious	5.0
<Rel> Haram ka maal kha kha kar haram ka hi hogya hai yeh sahafati dalla <Rel>	Religious	5.0
ğŸ˜·ğŸ˜· mer bari ay <Rel> tu haram hogya ay <Rel> ğŸ˜·ğŸ˜	Religious	2.0
<Rel> Abay haram zaday masjid mai kanjar nachatay ho <Rel> nam Islam ka laitay ho <Rel> kafro <Rel>	Religious	5.0
Saryy <Rel> is haram khor <Rel> ko block kro or report maroOğŸ¤«ğŸ¤«ğŸ¤«	Religious	3.0
<Rel> Haram zaday <Rel> tujay masjid Wazeer Khan mai dance kartay hoay sharam nai <A/O> jaisi maa kanjar vaisa Baita kanjar <A/O> .... <Rel> Salay is say acha tu hindu paida ho jata kaminay <Rel>	Religious	5.0
Sona mardon p Haram hy ğŸ˜‚	Neutral	0.0
Hamy apny ap par tars ay na ay pakistan py tars aia h. Tum log sirf khud ko sochty ho jesy tumhara leader.sab idaro ko andr sy khokhla krdea sirf is wja sy k mjy koi pochy na sabko khilao. Shaed ap b un mein sy ik ho .ku k cheekh wohi raha h jisko haram milna bnd hoa	Neutral	0.0
<Rel> Ye pgl ka bacha h haram khorr <Rel>	Religious	4.0
Phir saida saida band ker parliament ko mughal raj hi chalana hai. <A/O> Ais baghairat <A/O> sc ki waja se pak ko 6 billion dollars ka fine ho chaka hai lekin <Rel> haram hai koi sharam ya haya <Rel>	Religious	4.0
<Rel> Lakh lakh LAANAT ALLAH KI on those who forced presiding officers to change results <Rel> . If some institution getting pay from TAX PAYERS is involved <Rel> they are eating HARAM to their families and adding HARAMIS in Pakistani population <Rel> .	Religious	5.0
Haram ha as aurat ne kbhe sach bolna ha... Sar sar ro ro kr zindgi guzar degy	Neutral	0.0
Again DFM jub <Rel> ap jaisi aulad jokay haram ki kamai say pali gai ho uska reward apkay haram khooor baap ko rubnay duniya main hi diya tumhari surat main <Rel> ......... jisay har banda hissa mangta hi nazar atta hay	Religious	5.0
<Rel> HARAM ZADI <Rel>	Religious	3.0
Oh .. send your 2 million refugees to India and we will then see who is who.. namak haram!	Neutral	0.0
I am fineğŸ˜Š Sooti hoon fajr prh kr Thori dair baad ...behn bhai sary Ghar me shorr daal kr jeena haram kr dety hain ğŸ˜…	Neutral	0.0
<Rel> Haram khan <Rel>	Religious	3.0
Border py apny bhai ko bhej do ya hmara mulk chor dein .... <Rel> Ghadr namak haram <Rel>	Religious	3.0
phir tu prize bond bi haram hay , bank job bi jo non Islamic hain wo bi jaiz nhi, lambi bahas hay phir kabi daliyal say proof karoon ga sister jazak Allah	Neutral	0.0
<Rel> Haram ki ollad harram ky kaam <Rel>	Religious	5.0
haram toba	Neutral	0.0
Billi na dikha inho ne mera jeena haram kiya hua aaj kalğŸ™ŠğŸ˜‚ğŸ˜‚ğŸ˜‚	Neutral	0.0
<Rel> iss haram zaday ky liay lanat bhi panah mangti hy kahan kahan mun kalay kiay hain nasli khota <Rel>	Religious	5.0
Kidhar gharak ho gaya khud foj main or bachay bhi dal kar sambhalta chocha <Rel> haram ki nasal <Rel>	Religious	4.0
Woh jo dil mein qayam karte hain wohi jeena haram karte hain.	Neutral	0.0
yes you are right after nikah it's not Haram...	Neutral	0.0
RT : Apno ka ek taana pata ni kitni raaton ki neend haram krdeta hai.	Neutral	0.0
<A/O> Kutty k bachi <A/O> konsa vote <Rel> haram khor nasal pak k <Rel> tabhai py la khra kiya ha yahn insaf nh ho rha tmhry paly huye <Rel> kutton sa Allah k adlt Me na haram k pasia chlyva na tmhri koi chez Allah pak k lanat ho tm py tmhry khandan py <Rel>	Religious	5.0
<Rel> Ye wazeer haram khor <Rel> , humain b promote kra dety tou kya jata in kağŸ˜·	Religious	3.0
<U> Haram hy awaam <U> ğŸ˜‚	Untargeted	3.0
Kinda want to reinstall ludo star but its haram ğŸ’”	Neutral	0.0
Jeena haram*	Neutral	0.0
But we against haram too ğŸ‘‰ğŸ¼ğŸ‘ˆğŸ¼ so yeah	Neutral	0.0
Aise <Rel> koi haram nasl ka kutta hai Ye Sohail Tanvir Chutyiaaa <Rel> #MSvIU	Religious	5.0
Ye tou haram nahi thaâ˜ ï¸	Neutral	0.0
And i know because i don't want such haram relationships ğŸŒ¸	Neutral	0.0
<Rel> Haram Zada Kanjar MUQASAR <Rel>	Religious	4.0
Kro quraban ...haram hi woo chooron pe he qurabn...Allah ko yeh nhi chaye	Neutral	0.0
Ufff luckiest moment of life cant explain my feelings when see video. Me and my family was lucky enough to pray behind this great man many times during our Umrah,20,Feb, 2019,5times prayer in Haram Mecca Ya Allah call me again with family,and my dearest brother,M,Faiz Ahmad Late,	Neutral	0.0
RT : Sharab Rab ny Haram rakh d Phir kiu Rakhi Halal Ankhin Hazaru in sy Qatal hovy hn Khuda k bndy Sambhal Ankhin	Neutral	0.0
Yaar love marriage nahi hoti to arrange e krlo, haram krnay me sb lion ho, hlal me geedar ban jatay o.	Neutral	0.0
We can never save ourselves from the haram of interest based IMF loans without establishing the khilafah. #EstablishingKhilafahIsOurDuty	Neutral	0.0
<Rel> Good maro in haram khoro ko <Rel> inka baap ka pakistan hai pakistan baba Jan Ka Labik walo ka hai nahi chora ga ..	Religious	4.0
no matter what, haram is haram at the end of the day. stop trying to justify haram things pls	Neutral	0.0
<Rel> Maa b beti k lifafay hi khati <Rel> hai <Rel> jub haram khaen gaey tu aisi dua hi karain gi <Rel>	Religious	4.0
<Rel> Behan cohd ho tum bibi haram ki nasil ho tum <Rel>	Religious	5.0
Haram on so many levels	Neutral	0.0
ap bh ladli the phr ap ko <Rel> haram khanay ki lat lag gai <Rel>	Religious	3.0
Ye mai hun Ye mery sath meri billia hain Ye rat ka 1:33 bj gya hai Or ye meri neendyn haram ho rhi hain	Neutral	0.0
Kuch larke or larkiya is liye bhi Single hein kyun ke wo Nikah mei Yaqeen rakhty hein naa ke Haram rishton mei	Neutral	0.0
<Rel> Gadhe haram khor <Rel> aik banda jo nawaz aur zaradri ke khilaf khara raha aur itne madad ke unko harane main wo bura hai. Aur zaradri nawaz jo kharbon ke chor hain aur court se ceritify dacoits hain wo leader hai aur unke dalale krte hue tum jaise log fakhar mehsos krte ho	Religious	4.0
Yehi k ap Bahot Hadd Haram hain ğŸ™ƒ	Neutral	0.0
RT : ROSES ARE RED VIOLETS ARE BLUE VALENTINE'S DAY IS HARAM BUT I'D STILL MAKE DUA ASKING FOR U	Neutral	0.0
Teri prescription post krta hun bipolar ho gya tha <Rel> tu haraami <Rel> ğŸ˜‚	Religious	2.0
Nani hona koi gali nahi albata becharay <Rel> yahoodi khan <Rel> ko Dada aur nana bana naseeb hi nahi ho all ready 70 saal ka hai Allah ko kissi waqt bhi pyara hoskta hai	Religious	2.0
<A/O> You pagal aurat <A/O> ğŸ˜‚	Abusive/Offensive	1.0
Haseen aurat	Neutral	0.0
<A/O> Ankhen he ya button o patwaran <A/O> . Zara ghor se dekho k kya he. Yeh mask he. <A/O> Parhi likhi jahil aurat <A/O>	Abusive/Offensive	5.0
Ye ap mulk ko baddaua de rei hai . <A/O> Aisi pagal aurat <A/O> ... â€œjiski London tu kiya Pakistan ma koi property nahi â€œmeray koi 90 ye 95 lac k asasay hain aur ma regular text pay krti hon â€œ jhooti aurat . Power stricken	Abusive/Offensive	2.0
AM Multn is not under any single organization &amp; is work of activists, students, &amp; community mmbrs, with support from Aurat Marches &amp; women's orgs. AM Multn is mostly the work of community mmbrs One of our organizers shares why she marches #WhyIMarch #AuratMarch2021	Neutral	0.0
Mola Ali a.s or Ahl e bait ki taleemat humy y btati h aurat Na mehram se parda kry or mard Na mehram Aurat ko na dekhy Hum manty to h Ahlebait ko lekin unki ni manty is m my bhi brabar ka qasurwar hu Allah hum ko hidayat dy Amen Syed Sajjad a.s chadron ka name sun k roty thy	Neutral	0.0
<S> Gandi aurat <S>	Sexist	3.0
Me ne ek Aalme Deen se suna hai Nabi Paak ne farmaya hai Keh koi aurat apne jism pe naqsho nigaar aur ghair zruri zebaish kre gi tu wo aurat Jannat mei daakhil tu dur, wo Jannat ki khushbu bhi nai soongh paye gi.	Neutral	0.0
Allah SWT ap ke jyez maqsd pure kre g Ameen Wese mard o aurat ko iss qism ke threads manah hain Baqi ap ki marzi	Neutral	0.0
Bat sirf aurat ki nhi.,yeh aaj k door ki Haqeeqat ha jis Mard ki Jaib khali ha uska koi wajod nhi.,	Neutral	0.0
<S> Tu b chor tera bap b chor bazaro aurat <S>	Sexist	4.0
Kya sirf aurat ke bat ho rahe ha ?	Neutral	0.0
<A/O> faarighh aurat! <A/O> ğŸ˜‚	Abusive/Offensive	1.0
This Aurat give trp to NAMAK . I knew it tu hi hai woh dhokebazzz ğŸ˜¤ğŸ˜¤ğŸ˜¤ğŸ˜¤ğŸ˜¤ğŸ˜¤	Neutral	0.0
<A/O> Jahil Aurat <A/O> question dekh ğŸ˜‚ğŸ˜‚ğŸ˜‚ ulta hi jawab deti hai ğŸ˜‚ğŸ˜‚ğŸ˜‚ğŸ˜‚	Abusive/Offensive	2.0
Need serious action against this <A/O> stupid Aurat# <A/O>	Abusive/Offensive	1.0
<Rel> Ketni koi makroo aurat hai yeah <Rel>	Religious	2.0
"Nayaab hain wo mard,jo gusse mein bhi Aurat"" se baat karne ki tameez nahi bhultte!""ğŸŒ¸"	Neutral	0.0
Ye to in k halaat hain. Phr inhein Aurat March k posters say masla hota hai.	Neutral	0.0
Ye kon aurat......hai	Neutral	0.0
222ğŸ˜­ğŸ˜­ğŸ˜­ğŸ˜‚ <A/O> besharam aurat <A/O> ha	Abusive/Offensive	1.0
<A/O> tarbeyat main kami ki zinda misal <A/O> .... <Rel> shetan Aurat <Rel>	Religious	3.0
Yh ap ko aurat March mein help kary ga paka........ğŸ˜‚ğŸ˜‰	Neutral	0.0
Wth is aurat March???ğŸ¤¦â€â™‚ï¸ğŸ¤·â€â™€ï¸	Neutral	0.0
Ridiculous... Aurat March is probably gearing up to demand reduced defence budget, de-militarization of Balochistan and non alignment with China at UN on Ughur issue None of these issues are women centric That LEFT gaslighting masses and pushing another good movement to the grave	Neutral	0.0
Some dirt of this society is ready to spread it more in our society like toxic march of aurat <A/O> they are below the moral values they are social beasts <A/O> just <A/O> #LanatAuratMarch <A/O>	Abusive/Offensive	4.0
<S> jo aurat 4 month main bchi paida kar sakti he wo is tarha hi boly gi <S>	Sexist	3.0
There is nothing wrong with Aurat March. It should be promoted. But if they wants to bring vulgarity in the name of freedom, this will nit going to be happened sisters. Know your place and bring the change.	Neutral	0.0
RT : Say No to dirty &amp; <U> lunatic aurat march <U> .... its just <U> lanat march <U>	Untargeted	4.0
I m that one âœ‹ becoz i think <U> aurat march is just a lanat <U>	Untargeted	2.0
<A/O> Right aisi aurat ke sath rehne se toh acha Stay Unmarried. <A/O>	Abusive/Offensive	2.0
Because tum jesey wahan us aurat ko xray kr rhe hotay ho. Jao bartan dho <A/O> farigh admi <A/O> .	Abusive/Offensive	1.0
<S> Aurat Mard ki ğŸ‘« Wo izZat hai â¤ï¸ jiSy wo jagAh ğŸ˜ jagAh rulata hai <S> .. ğŸ˜ª I'm included with or U alSo brO .. ğŸ˜­	Sexist	5.0
I want to go to the aurat march sooooo bad lekin last year they literally threw bricks at people so I'm really scared and idkkkk ugh	Neutral	0.0
Yai aurat bhi apni Calibri queen ki turha fraud hai	Neutral	0.0
These aurat marchians are bunch of privileged hypocrites who has nothing to do with women rights. Infact their hidden agenda is to promote homosexuality, endorse LGBTQ and abortion and atheism.	Neutral	0.0
idea of Aurat march is good but people organizing it is not good	Neutral	0.0
<S> Women should focus on their children's education more than 'Aurat March'. <S> #AuratAzadiMarch2021 #AuratAzadiMarch #feminist	Sexist	2.0
Ye Aurat Azadi March wala Fasion hy	Neutral	0.0
Yeh meri baat ka jawab nahi? Why not male:p yahan aurat march wali auntiyon ne aitraaz kar dyna Female se vaccine kun lagwai ja rahi hai...	Neutral	0.0
<Rel> Munafiq molvi <Rel> ak trf khtay hu aurat ky hukmarani jaiz ny dosre trf support krtay hu..	Religious	4.0
Ye sab to theek hai lakin aurat March main ya sab nahi hota waha men are dogs Ke naarey lagaye jate hain or flyers pe jo kuch likh Ke laya jata hai wo bhi sab ko pata hai	Neutral	0.0
This a regard for women that only mehram can tke her name. Allah pardon main rkht hai. Aurat ki deadbody ko to baap bhai betay k ilawa ksi ko touch krny ki bhi ijazt nhi qabar main utarty hwe. Bibi go and learn some shariat.	Neutral	0.0
<A/O> Pagal aurat bb13 main b apni asliyat dekhayi aur bb14 mn b <A/O> ğŸ˜‚ğŸ˜‚ğŸ˜‚par na tou shehnaaz ka kch kr saki na rubi kağŸ˜‚ğŸ˜‚ğŸ˜‚ğŸ˜‚dono agy chali gaiğŸ’•ğŸ’•ğŸ’•ğŸ’•ğŸ’•ğŸ˜ğŸ˜aur tum dusron ki chaplusi kar rehna humsha	Abusive/Offensive	3.0
What kind of AZADI you women's want, if every one follow the sunah, then there every one will be happy with their life even they are men or women, Alas! Everyone want to participate Aurat Azadi March instead of follow their duties and rights which islam described 1400 years ago	Neutral	0.0
wah, zaberdast dekhain aurat, job ya karbora kar sakti hay, like Hazrat Khadieeja R.A apni pasand ki shadi kar sakti hay, like Hazrat Khadieeja, not equal to man, islam says also,	Neutral	0.0
<S> Bazaro aurat ki zuban as usual...... Bad tamezi, besharmi, dhetai se bat krna <S> ...... Shayd aski tarbiat r bughz asymar he dega	Sexist	5.0
Aurat Azadi march has dedicated this year's march theme to legendary Baloch women As they are the leading stars of a political struggle against every form of injustice and oppression in an extremely tribal society. #auratazadimarch2021 #EndEnforcedDisappearances	Neutral	0.0
<A/O> Tum Aik jahil aurat ho. <A/O> <A/O> Indian paid ho. <A/O> Pakistan Msin koi b tummy Munh nahi lagata	Abusive/Offensive	3.0
Aurat March is only on Media and some INGO paid aunties	Neutral	0.0
What's wrong with it. ? Mera khial hei k achay khaandaan ki aurat khudh b nahi chahy ghi k har koi oska naam jaanta phiray or sab mardon ko jaantay hotay hein tu ise convenient samjhtay hein	Neutral	0.0
Oyy hooy bhout zulm hota hai aap pr Aunty ğŸ˜¢ phr sa Aurat march start hogeya libral akhty ho jay ga ab ğŸ˜¹	Neutral	0.0
Lol, bb result is getting out of aurat march	Neutral	0.0
Why only Aurat March ?? Why not the Mard March ğŸ¤­ğŸ˜·	Neutral	0.0
Yessss just behayai burai jo azadi ye aurat chah rai hy wo zalalat k ilawa kuch ni	Neutral	0.0
Ina lillah, both should follow islam v easy mard ho ya aurat	Neutral	0.0
Aurat March is coming. And so is <A/O> Khalil ur Rahman Qamar and his zalalat. <A/O> Please donâ€™t appear on panels &amp; talk shows with him. Check whoâ€™s on the show before accepting the invite. Heâ€™s invited precisely to abuse women &amp; drive up ratings/make clips go viral.	Abusive/Offensive	2.0
<A/O> Ppp main koi sharif aurat bhi hai ya sub ap ki trhan han <A/O>	Abusive/Offensive	1.0
<A/O> Ye aurat waki main pagal ho chuki by <A/O> ....itna bugsy imran	Abusive/Offensive	2.0
I'm nazarrrrr fromm youuuuu <A/O> kamini Aurat <A/O> mereko naa bataya ğŸ˜­ğŸ˜­ğŸ˜­ğŸ˜­ğŸ˜­ğŸ˜­ğŸ’”ğŸ’”ğŸ’”ğŸ’”ğŸ’”ğŸ’”	Abusive/Offensive	2.0
Is aurat ne jahalat nahe khatam honay deni! Corona tou is time different cities ki markets, marriage halls, restaurants and baqi jagah se bhe nahe khatam hona agar ese he chala!	Neutral	0.0
Ek aurat ho to haan lekin ek se zyada hon to nhi...	Neutral	0.0
Aurat Bari piyaari cheeze hai app uss usski ek Sunno usnay app ki ek Bhi sun nee...ğŸ¤ªğŸ¤ªğŸ¤ªğŸ˜‚ğŸ˜‚ğŸ˜‚ğŸ˜‚ğŸ˜‚	Neutral	0.0
aik to <S> sari shia community ka thrka is aurat ny uthaya huwa ha <S>	Sexist	3.0
<A/O> Khabees aurat <A/O>	Abusive/Offensive	2.0
Haan jee yahi pata chalta hai k app aurat zaat ki kitni respect kartay hein Ya kitni app ko shikaye Gaye hai... Barhaal aesay logo k liye block ki option toe hai naa...	Neutral	0.0
<A/O> ye chawal har mahinay yei chawal marta hai churail aurat <A/O> ko chaiye is na ehal mulazim ko laat maar k nikal day <A/O> lafafay group mein say koi new chawal ati he nai isay <A/O>	Abusive/Offensive	4.0
Hahahaha <A/O> pagal aurat ka pagaloon wala tabsra <A/O> ..... <A/O> U r filth <A/O> ...	Abusive/Offensive	4.0
Yh tarbiyat pr depend karta hai mard aurat per nahin I think so	Neutral	0.0
Kasay jan chootay ge <A/O> is churail sayy <A/O> ... <A/O> yeah makar aurat hamari naslain khaaa jaye geee <A/O> ..yeah Nawaz shahbaz say b 2 hath agay hy...ğŸ˜­	Abusive/Offensive	3.0
Koi shreef aurat lg rhi hai ye to ğŸ™‚	Neutral	0.0
RT : Har jagha aurat card khailna zarori nahi hota Apne onki baat ko beech mein se tooka	Neutral	0.0
<A/O> Boht he besharm aur daheet aurat ho tum <A/O> .	Abusive/Offensive	3.0
<A/O> Ser jaa ty maar jaa <A/O> tera kuch nahi bnayağŸ¤£ğŸ¤£siway zaleel hon dy ty <S> gandi aurat mashoor hon dy <S>	Sexist	4.0
<A/O> Pagal aurat <A/O> ğŸ˜¡ğŸ”ª	Abusive/Offensive	2.0
Sahi jawab ha aurat	Neutral	0.0
Ya mai islamabad main beith ka wahan ka hal pictures s adakh bol ri <A/O> ghatiya aura <A/O> t . <A/O> Bakwas kerna iski majbori hai <A/O>	Abusive/Offensive	4.0
Tumhein bara pata hai <A/O> chaklay ki paidawar Ka mujhe to tum khud chaklay ki paidawar lagte ho. <A/O> Aur doosra <A/O> tum jaahil patwari pe laanat aur iss aurat pe bhi. <A/O> <A/O> Doosra chaklay ki paidawar ki Baat na Karna warna Aisa thok Kar jawab doun ga Yaad rakho gay. <A/O>	Abusive/Offensive	5.0
<A/O> Q teri bhen abi d chowk pe nangi bethi hy patwario k rocket launcher dead krny wali aurat k bachy <A/O>	Abusive/Offensive	5.0
<S> Jis aurat ny mujrey ga k paise kamaye hon <S> .. uss ko PSL 6 ka anthem song dy dya.. yaar cricket k shokeens chup hain.. utho yaar	Sexist	4.0
Hahahaha <A/O> makar aurat makari adakari <A/O> wo bhi kisi kaam ki nahi your movie is flop bibi.	Abusive/Offensive	3.0
<A/O> Ye Kuttey Ka Bachcha <A/O> Bus Apni Jhaarta Rehta Hey.., <A/O> Is Kanjar <A/O> Ko Kya Pata Wahaan 2 Jaanain Zaaya Ho Gayi Hain.., <A/O> Is Kanjar <A/O> Ko Kya Pata Ke Jo Aurat Vote Cast Karney Ke Liye Israar Kar Rahi Hey Usne PTI Ko Vote Daina Hey Ya PML N Ko ???	Abusive/Offensive	5.0
Mard ankhein neechi nahi krna chahta, Aurat pardey ko jahalat smjhti hai... Magar dono ko Izzat aur Ehtaram ki talaash hai.	Neutral	0.0
RT : Ager equality ki baat kee jye to aurat kabhi bhi mard ki tarha ek dress 5 shadiyon mein pehan ker nahi jasaktiğŸ¤­ğŸŒ	Neutral	0.0
<Rel> Badmassh aurat apni harami leader ki Tarah <Rel>	Religious	4.0
<A/O> iss pagal aurat <A/O> ko ye shyd bhool gya k gwaadr main rehnay walay log b pakistani hi hain pakistan ka acha image ja rha sari dunia k samnay...	Abusive/Offensive	2.0
tum subha say jgah jgah yehi tweet kr rhi ho <A/O> pagal aurat <A/O>	Abusive/Offensive	2.0
Soja <A/O> pagal aurat <A/O> ğŸ˜Œ	Abusive/Offensive	1.0
<A/O> Lanat ki mari aurat <A/O> tjhe vote parties nai dekhie teh?	Abusive/Offensive	3.0
It is not acceptable in Islam and first we are a Muslims then we are pakistani so please stop this ky nikkahfied hogaye toa khuly aam krlo sb? Open minded kaha likha ha kahin aesa ky humhary religion mn ky nikkah ky bd aesy krny ki ijazat ha bibi aurat py burkha krna lazm ha.	Neutral	0.0
<A/O> aby o bc <A/O> yh dono tujhy prime minister shakal sy b nazar aty hn	Abusive/Offensive	3.0
Tasveer achi na aane pe pehla kasoor Camera Ka Hota Hai, dusra Background ka, teesra Tasveer khenchny waly ka, Apni shakal pe tou shak karna hi Gunnah hai	Neutral	0.0
<A/O> Teri manhoos shakal py lanat <A/O> , <A/O> ghtya insan <A/O> Pakistan ka khaa k Pakistan k khilaf ei <A/O> bhonkta hai <A/O> hmesha. <A/O> Sasta intellectual. <A/O> Aj tk koi ek bola ho toooo ny.	Abusive/Offensive	5.0
kis ki wafa dar hy jis nay lahore ka ganda tareen ker dia hy kash hum sb say is bat ki khabar lay sakty but awam kuch ni ker sakti sirf rulers ki shakal hi daik sakti hy	Neutral	0.0
Haan openly bachiyun down ki ja rahi hain ğŸ˜‚ Civic likh m shakal achi ni hai likh deta hn cool lagn ga ğŸ˜‚ğŸ¤¡	Neutral	0.0
Yar kitni batmizee behen ho ap <A/O> ap ki shakal ki b mn acchi bana hi deti hon wo b nii acchi <A/O> .. ğŸ˜¢	Abusive/Offensive	2.0
Itni buri or single wali shakal bhe nahe hai yarğŸ’”ğŸ˜­	Neutral	0.0
RT : Bhai me kis ka jigar hun shakal dikhao? ğŸ˜¬	Neutral	0.0
jab shakal ni dekha skte te to to esi selfiee q lee hoooooooooooooooooooooooooooo......!!!!!ğŸ˜‚ğŸ˜‚ğŸ’”	Neutral	0.0
mje bestie ki shakal bhi dekhni hai	Neutral	0.0
Mujhe apni shakal par yaqeen hağŸ™ŠğŸ˜‚	Neutral	0.0
Teri shakal se nafrat ho gyi hai...	Neutral	0.0
<A/O> Yeh insan nahi .insani shakal mn chupy darindy hoty <A/O> ğŸ™„	Abusive/Offensive	4.0
Wesy kafi milti julti shakalğŸ˜‚ğŸ˜‚ğŸ˜‚ Nazar na lagy basğŸ˜œğŸ˜‚	Neutral	0.0
<A/O> Sastaa tatttoooo <A/O> ....ğŸ’.... tooo avien sasti chorrta rehta marketmn thrill machaya hota. <A/O> Teri shakal dekh k BO high ho jata pta ni itna manhoos kiu hai tooo toffee <A/O>	Abusive/Offensive	4.0
Wo kehty na khrab Malta ko dekh dosra Malta bi Khrab ho jata (main kharboza bi keh deta per uskeliye shakal bi honi chahiye nağŸ˜‚ğŸ˜‚ğŸ˜‚ğŸ˜œ)	Neutral	0.0
Shakal mein kya rakha hai janab...seerat to heere se bhi saaf hai... Rabb Mehar kareğŸ™ Tarakiyan bakshe	Neutral	0.0
Jaa jaaa <A/O> reis-buckler's dystrophy jese shakal bay tere r batain choodta hay bsdk <A/O> ....	Abusive/Offensive	5.0
Hm ny kab Kaha h Hamin pasnd Kijeaiy ğŸ™ƒ Jaieey nikliaeey Shakal Gum kijeaiyğŸ”¥âœŒï¸	Neutral	0.0
Tere na jaiz baapp ki halalt ye thi <Rel> kuttttee sour ki tara teri shakal ha or haramiiikhoor tu itna ha k paise k liye apni maaa ko b bech de khotii k bachee <Rel>	Religious	5.0
Shakal pe marnay walo, don't expect loyality from them. Cox u didn't fall for that.	Neutral	0.0
<A/O> Bhonkta raha kuty ki shakal walay tum log ho hi gand jab kuch or nahi hota to dusro k mazhab pr atack krty ho <A/O> tang nazar log tbhi to aj sikh bhi tum logo k muh pr jutian mrty hain	Abusive/Offensive	5.0
<Rel> Or Tra bhgwan bndar ki shakal ka jesy teri shakal kuty wali hai <Rel> teri dp dekh kr hi pata chal raha hai <A/O> teri maa ka husband koi insan ni koi kuta hi ho ga <A/O> ğŸ˜‚ğŸ¤£ğŸ˜‚ğŸ˜‚	Religious	5.0
Faisalabad ke road kab sahi hoge,sari shakal mitti nal bar değŸ¤·ğŸ¼â€â™‚ï¸ğŸ¤¨Uper se February pe dhupğŸ™ƒ	Neutral	0.0
<A/O> Jawab dainy wali shakal e nai thi aagy sy:) <A/O> just said sorry sir.	Abusive/Offensive	1.0
Photographer is good.. Camera is good.. But my shakal ain't..ğŸŒš	Neutral	0.0
Ab Shakal Se Tum Bhi <A/O> Sir Ke Bal Sarak Par Gheesiyaan Karney Waaley Lagtey Ho <A/O> ..,Magar Humne Kabhi Tumhaarey Baarey Main Aisa Kaha ..Allah Ne Subka Parda Rakkha Hua Hey Is Liye Doosron Ki Pagri Uchhaalney Se Pehley Apna Sir Utaar Kar Side Par Rakh Diya Karo..ğŸ˜‘	Abusive/Offensive	2.0
<A/O> kia manhoos shakal ay teri. <A/O> kitna iqt'daar chahiye tumhain ? Firoun Jitna ?	Abusive/Offensive	2.0
RT : Log Seerat ka Sirf Rona Rote hain Baat Har Koi Shakal Dekh Kar hi Karta hai ğŸ¥€ğŸ’”	Neutral	0.0
Ab shakal dekhna toh lazmi hai. Jab larki shakal dekh kr bat kre ge toh larky kion ni. ğŸ˜…ğŸ˜…	Neutral	0.0
RT : <A/O> Na shakal ha na aqal ha <A/O>	Abusive/Offensive	2.0
<A/O> Kabhi seeshy main shakal ni dekhi? <A/O>	Abusive/Offensive	2.0
Jb umer gul yahn aya tha tb khud kiya tha??? Shakal dekhi thi tb isko.... Bhot hi ajeeb	Neutral	0.0
<S> Pakistani Girl's ki Shakal Pakoray jaisi or Nakhry ğŸ• Pizza jaise <S> ğŸ¤ªğŸ¤£	Sexist	2.0
<A/O> Shakal vekhi ae apniiğŸ™ <A/O>	Abusive/Offensive	1.0
"Btane ka shukria miss <A/O> ""shakal Q mobile nakhra Iphone"" <A/O> ğŸ˜‚"	Abusive/Offensive	2.0
If Almighty gave you husan it doesnâ€™t mean k baki sb ki shakal kachry jesi hai.. dont be proud beta!	Neutral	0.0
<S> Pakistani larkion ki shakal kichri jesi or nakhry biryani jesy <S> ğŸ˜‚ğŸ˜’	Sexist	2.0
Behaviour! Apki shakal ya apky dil sy kisi ko koi farq ni prta..They are for ur own benefit but they way you behave/ deal with others,matters alot.	Neutral	0.0
bruhhh shakal tw dikha diya krr ajeeeeb	Neutral	0.0
Sachi bata <A/O> kaun sa Nasha karta hai Dekh teri shakal bhi aisi hai jaise aam choose ke fainka ho <A/O> ğŸ˜‚ğŸ˜‚	Abusive/Offensive	4.0
<A/O> Modi tu ki shakal kisi bandar se kam nahi <A/O> .. <Rel> Cow urine ki tarah mou ha aus ka. <Rel> hehe	Religious	4.0
<A/O> Lakh di lanat Terii shakal ty <A/O> ğŸ˜	Abusive/Offensive	4.0
<A/O> Lanat Teri gandi shakal par <A/O> ğŸ–ğŸ»bey shumar	Abusive/Offensive	4.0
Bhar mei ja ay shakal khush ikhlaqi/ kirdar matter karta hai	Neutral	0.0
Shakal Allah Pak ny bnai ha jnb	Neutral	0.0
<A/O> Shakal achi hai tw baten b achi kro <A/O> ğŸ˜…	Abusive/Offensive	2.0
<A/O> Jahil insaaan <A/O> ho ap ALLAH ki bnayi hoi shakal me aib nikal rhy o???politics 1 tarf ap ki tarbiyyat hi aisi hoi hy lagta	Abusive/Offensive	1.0
I am big supporter of Imran Khan and PTI but har insan ki shakal Allah ne banayi hai aur koi aisi shakal nai jo ghaleez ho........ Haan amaal achay burey zaror hote hain.......	Neutral	0.0
<A/O> Y shakal sy he gando lagta hy <A/O>	Abusive/Offensive	3.0
bhai central punjab ki awam hi asi ha , inko wohi Aloo Gosht wala Mnhoos shakal ka chahiay	Neutral	0.0
<A/O> Shakal b lanti Kam b lanti ! <A/O> Betha USA m h or <A/O> bhonk hum pe Raha h <A/O> wahan hi catto Kisi ko <A/O> zaleel insan ! <A/O>	Abusive/Offensive	5.0
<A/O> Apni shakal ghour se dekh lanat ka mtlb samjh aa jaye ga <A/O>	Abusive/Offensive	3.0
Itni shakal change ni hue jitni parties change ki hy ğŸ˜‚ ğŸ˜‚	Neutral	0.0
<A/O> Laanat iss shakal pe aur tujhe jaahil patwari pe <A/O>	Abusive/Offensive	3.0
Shakal Dekho ktni masoom e or andar say lomri e ğŸ˜‚ğŸ˜‚ğŸ˜‚	Neutral	0.0
<Rel> Bosdke tre gandi shakal dekh k khof arha h maadrchood cow ka pie peeny waly hat bosdike keğŸƒ <Rel>	Religious	5.0
<A/O> Es takkeeee ki shakal kitni manhoos hai. <A/O>	Abusive/Offensive	2.0
Besharam insan, <A/O> teri okat kia hai 2 takkay k tm bnday ni ho <A/O> , tmeez sy name lya kr President of Pakistan ka. Too jall jall k mar jy ga Imran Khan k bughaz mn. <A/O> Sasta intellectual. <A/O> Ja dafa ho. <A/O> Teri to manhoos shakal dekh k BP high ho jata bnday ka. <A/O> <A/O> Manhoos shakal <A/O>	Abusive/Offensive	5.0
<A/O> Lanat dar teri shakal te <A/O> govt men hote hoe tu kuch ni kar saka sai kehte hn na ehl or nikame hn	Abusive/Offensive	3.0
is me kon si shakal nazar a rhi ha jo haseen ğŸ™‚ğŸ˜‚ğŸ˜‚ğŸ˜‚	Neutral	0.0
<A/O> Trii shakal vekhh k kssi nyy wishh ee nhh kitaa <A/O> ğŸ˜…ğŸ˜…ğŸŠğŸŠ	Abusive/Offensive	1.0
daddy ?ğŸ¤¡ astagfirullllah Astagfirullllah its haraam broğŸ¤¡	Neutral	0.0
O tu mere level di ni Shoriyee, <Rel> Tu barri Haraam moat marna eyy <Rel> ğŸ¤¡ Kon ho bhae ap?	Religious	3.0
Dear Muslims ! Stay away from Shirk.ğŸ’”ğŸ˜” Astagfirullah ğŸ’” This is haraam!	Neutral	0.0
<Rel> Haraam khor <Rel>	Religious	3.0
Ye NGOs mulk k baqi hisson me b active h magar waha sab kuch halaal or pashtoonkhwa watan me development haraam h, pre planned	Neutral	0.0
Haraam h agr Yh National Team mein Acha khela hu. #LQvQG #PSL62021 #lq	Neutral	0.0
Tu bohat <Rel> haraam mout marna hai <Rel>	Religious	4.0
relation haraam ni hoty un ka galat istmal krny wly harraaaaaaam hain.......	Neutral	0.0
Wese <Rel> boht hi haraam khor log ho tm <Rel> jahan jahan jeet jao wahan sb thik hota he or jahan kahin haaar jao wahan dhandli hoi yargmaal ho gaye etc... Band kren ye drama bazi awam ko bewaqoof hi bnaya howa he sb ne mill kr	Religious	3.0
<A/O> SaliA/O> tu same dekhte hai gussa karte time	Abusive/Offensive	1.0
<S> Sali rand <S> i 2 August ko chadar 4 dewari yad a jani	Sexist	3.0
<S> Sali Ganddi Aulad Naa Maza Naa sawad# <S>	Sexist	5.0
Whenever i send streak of my glasses ğŸ˜”ğŸ˜” Sali tut jati hayâ˜»â˜»	Neutral	0.0
RT : ALLAH Huma Sali wa Salim wa barik ala nabiyna MOHAMMED â¤ï¸â¤ï¸	Neutral	0.0
i felt the same way. being a girl who likes star wars is like trying to get love from a brick wall. nobody hears us except and sheâ€™s giving us a voice too ğŸ˜Œ gives me hope that one day soon someone will hear us and give us a star wars movie thats less sexist	Neutral	0.0
<S> Pak men 1st in sexist <S>	Sexist	3.0
<S> Khusra to tera leader ha bc jis k pass koi bivi tikhti hi ni ha <S> , Humza abbasi or Murad saeed ki stories ni suni <A/O> bhosari k kutto sa marwata ha tera leader <A/O>	Sexist	5.0
<A/O> bsdk <A/O> signals deya kr. <A/O> Ziada batain nah choda kr. <A/O> Or han inbox a	Abusive/Offensive	5.0
Yaar 2 din ke liye twitter choda tha ğŸ™‚	Neutral	0.0
tu losdya hi mar jana ay <A/O> bhn choda <A/O>	Abusive/Offensive	3.0
Han thk hai add ho ap Ab yeh batao <U> yeh bhenchod <U> gc bntaa kese haiiğŸ˜­ğŸ˜­ğŸ˜­ğŸ˜­	Untargeted	3.0
<U> Is bhenchod <U> mobile ki wjah se ankhen khrb hogai hen meri.	Untargeted	3.0
ğŸ¥º <U> bhenchod <U> ni ho ma	Untargeted	3.0
<A/O> Kukri bhenchod <A/O> lagwa dia na chaka	Abusive/Offensive	3.0
<U> Bhenchod <U> 6 kg weight or berrh gya hy	Untargeted	3.0
Sem <U> bhenchod <U> 2 din sey dekh raha	Untargeted	3.0
RT : Guys koi apna nh hota <U> sab bhenchod hotay hain <U>	Untargeted	3.0
It seem female Sab chupa k rakhte hain btata koi nai ğŸ˜¬ğŸ˜‚	Neutral	0.0
Chupa k use krti hoğŸ˜³	Neutral	0.0
Quran main zikar h k jb tm bahr nikala karo to chadar sy mu chupa lia karo...	Neutral	0.0
Lahulawalquwat, Both things wrong mean,s bhai bi ghalat hay aur behan bi ho gai ghalat, jo bhai ki karastani chupa rahi hy, pasand karna aur baat hy, yeh chakar wali baat ghalat hy, so ghalat, ghalat hay,	Neutral	0.0
wo kehna chah rahi hain mobile chupa lo	Neutral	0.0
Bol do jo dil ma chupa ha ğŸ˜ https://t.co/oryYzS46RW	Neutral	0.0
Lgta Hai Aap Live nhe dekh rahe..! Chupa Rustom nikla Salman MirzağŸ˜	Neutral	0.0
Ab mily ga to chupa k rakhi gi log jalty hein ğŸ˜”ğŸ™‚	Neutral	0.0
RT : Biryani chupa kar rakhi thee abu kha gayeğŸ˜«	Neutral	0.0
Match <U> loray lag chuka haii <U> ğŸ˜€	Untargeted	3.0
<A/O> tum ba apni behn , beti becho punjabion ko , behn k loray <A/O>	Abusive/Offensive	5.0
mein apna <U> randi rona <U> yahan nahi roun gi tou pagal hojaungi	Untargeted	3.0
Nah tum bachay ho or nah tum achy hoo tum bs <A/O> randi k bachay hoo <A/O> ğŸ¤£	Abusive/Offensive	3.0
Wo tou <S> Tum ( Mersn) ke Ghar ki Randi hain <S> ğŸ™ hamesha se #nawazlannati always ğŸ‘†ğŸ‘‹ğŸ‘‹ğŸ‘‹	Sexist	3.0
<Rel> Twaif randi chor tera bap b chor hramkhor <Rel>	Religious	5.0
Nikl <S> Stokes randi <S> ğŸ¤¬	Sexist	3.0
Still miss those chats then tea french toast <U> randi rona <U> as well as sleep sessions ğŸ˜‚â£ï¸	Untargeted	3.0
saari pareshaniyan kidhar hain bhae? yahi jo tu 2 ghantay pehlay <U> randi rounay <U> karha tha.	Untargeted	3.0
<S> meri taraf se randi bol do unhy ja k <S>	Sexist	3.0
Macchar daffa ho ja <U> randi <U>	Untargeted	3.0
Tum bi to khud ghuse ho mne kaha tha ao ya dawat di thi idr <A/O> randi rona <A/O> dalne ki	Abusive/Offensive	3.0
Awaein <U> randi rona <U> kr rha hn	Untargeted	3.0
Hazraaat pakistan mn <S> #AuratMarch ka randi roonay ka waqat hoa chahata hai <S> ... #AuratAzadiMarch2021	Sexist	3.0
<A/O> Chutiapun <A/O> asal ye hai k march start hote hi <A/O> inka randi rona shuru ho jata hai... <A/O> Jaoo yar jo krna hai kro nangay ho k ghumna hai ghumo sirr naa khao buss	Abusive/Offensive	3.0
<S> Nikl randi <S>	Sexist	3.0
It's not ronay it's <U> randi ronay <U> ğŸ˜‚	Untargeted	3.0
Abby side py lago <A/O> kisi sasti randi k bchy bchion <A/O> ki tweet py aisy munh utha k aty ho jesy token py pesy ziada mill rhy hun	Abusive/Offensive	4.0
RT : Ab bus bardast kijiye ga mere <U> Randi ronay <U> :)	Untargeted	3.0
Ab <U> Randi rona <U> krna ha me ne jab tak nend ni ati ğŸ™‚ğŸ¥€	Untargeted	3.0
Kia <U> bc <U> har wqt <U> randi ronayğŸ˜£ <U>	Untargeted	5.0
<S> Randi tere mou pe lanat <S>	Sexist	3.0
Waise everyone is against IU on TL except and and yet no <U> randi rona <U> from their side like Karachi supporters do.	Untargeted	3.0
Mjhe koi umeed ni ti <S> Wo is adalt Randi ka khota hi <S> ğŸ‘‹ğŸ‘Œ	Sexist	4.0
Nice. And yes, that is one of my problems with this platform. I came here for informative stuff, but it's all <U> randi rona <U> and sasty jokes here.	Untargeted	5.0
subha sunday ha to rat ko late tk <U> randi roney <U> kron gi ğŸ™‚	Untargeted	3.0
Idhr 12 baje aur idhr <A/O> apki behn zohii k randi roney <A/O> aur zindagi k dukh yaad ana shuru ho gaye ğŸ’”ğŸ¥€	Abusive/Offensive	3.0
<S> Ye randi <S> teri dost ha ?	Sexist	3.0
"The ""R"" in relationship stands for <U> ""randi rona"" <U>"	Untargeted	3.0
<S> kutty ki bachi shtup randi dalli <S>	Sexist	5.0
Oye chal bghairt, <A/O> tum logon sy ziada koi besharm Randi k bachy b ho skty hain?? <A/O>	Abusive/Offensive	4.0
<A/O> Randi rona <A/O> hun chad değŸ˜‚	Abusive/Offensive	3.0
<Rel> Kuta chor ghadar suar aa na pakistan hrrrrami <Rel>	Religious	5.0
<Rel> Woh dimag suar ka hai <Rel> na iska is liye yeh aisi harkate karte hai	Religious	3.0
han <A/O> bc inky tatton pe kala hit marunga ab mai <A/O>	Abusive/Offensive	3.0
<A/O> Oye tatton <A/O> dimagh sae hai?	Abusive/Offensive	3.0
<A/O> Tu ne b sasti nashe peene ke baad wali baat q bey kamini <A/O> ğŸ˜‚ğŸ˜‚ğŸ˜‚	Abusive/Offensive	4.0
Sasti harkty followers barhany k liyeğŸ˜†	Neutral	0.0
<S> Itni sasti to na bano na meri jaan ab har koi line marnay a jaye gağŸ¤¦ğŸ»â€â™€ï¸ <S>	Sexist	4.0
O come on imrannnnn...... dafa karooo in k gusay koooo.... sasti aunty haiiiiğŸ˜‰	Neutral	0.0
#KKvIU Agar Hamara aik bhi batsman set ho Gaya , Phir national stadium min biryani sasti pari hogi , bawa ji burger	Neutral	0.0
<A/O> Sasti hrithik roshan <A/O> ğŸ˜‚	Abusive/Offensive	1.0
Kar lay dramay sasti drama queen ğŸ˜‚	Neutral	0.0
Itni sasti mafi chahye ?	Neutral	0.0
Hahahhaha kia sasti jugat mari choro tum..	Neutral	0.0
Sasti shuhrat	Neutral	0.0
ğŸ˜­ğŸ’”fame fame hoti hai sasti ho ya mehngi	Neutral	0.0
Bs jo ap afford kr sken isi liye sasti kiâ˜ºï¸ Mehngi out of range ho jani â˜ºï¸	Neutral	0.0
Sasti shohrat k liay mari ja rhai hai...	Neutral	0.0
Sasti siasat... <A/O> be zameery logo <A/O>	Abusive/Offensive	3.0
Aesi sasti baton se kon pat'ta hai	Neutral	0.0
<A/O> Chutiya pan ap kro ! <A/O> Sasti hrkatain ap kro ! <A/O> Or bkwas ulta ? <A/O>	Abusive/Offensive	4.0
Then Ú† would be like your face. <S> Daffa ho bagair shlwar wali red light wali sasti treen orat <S>	Sexist	5.0
Pls teach me these sasti lines sensei	Neutral	0.0
Sasti treeeeen intellectual... yad rakhna Aunty, Qabar mn paisa kam ni ana	Neutral	0.0
Jbh ha... <U> bc <U> bila waja agae thi	Untargeted	3.0
Amir Sohail ka mic band karo <U> bc. <U>	Untargeted	3.0
<U> Bc <U> yeh iss month Mai theesri dafa papers le rahe Hain ALLAH SE DAR NAHI LAGTA SHAGUFTA!	Untargeted	3.0
<A/O> Bc To mary ge merey haton <A/O> panoti kahin ke	Abusive/Offensive	4.0
Pray for LQ <U> bcğŸ˜’ <U>	Untargeted	3.0
<U> BC <U> Yeh Adeez Nahi Hain... Inhin Jis Kaam Sy Mana Karo Yeh Wohin Kaam Zaroor Karty Hain	Untargeted	3.0
"Bro we had that and lost so bad <U> bc <U> agay se kehta ""ye gold aur diamond camo raja bazar se liya ap logo ne?"" ğŸ˜­"	Untargeted	3.0
<A/O> Esay koi kuttay log hen, <A/O> uski beti ki age ki hunme, mujpe line mar ra. <A/O> Bc. <A/O> Fact; Married log zyada khrab hen.	Abusive/Offensive	4.0
RT : I overwork myself bc I love distractions	Neutral	0.0
Id want Bryan Edwards bc he's 6'3 an has 81 speed on a 70 ovr card, but he didn't play much so it's unrealistic	Neutral	0.0
When I was in 6th-7th grade I knew 11th and 12th boys bc they used to be outside the class during board exams and I always used to stand outside the class. They used to say ''to kia yhin rhta hy pora din''? ğŸ˜‚	Neutral	0.0
You know that feeling when ur legs are freshly waxed and they smoother than a silk and you canâ€™t stop touching them? Bc Iâ€™m there.	Neutral	0.0
<U> Bc <U> tune to bna lia trend	Untargeted	3.0
ro <A/O> bc <A/O> ro	Abusive/Offensive	3.0
Ye agar virat ne padd liya <A/O> to teri g tod degağŸ˜‚ğŸ˜‚ Bc <A/O> sachin hai wo https://t.co/bseTqVJTLO	Abusive/Offensive	4.0
Abe <A/O> bc <A/O> dm krna tha yeğŸ˜‚ğŸ˜‚ğŸ˜­ğŸ˜‚ğŸ˜­ğŸ˜‚ğŸ˜­ğŸ˜‚ğŸ˜­ğŸ˜­ğŸ˜‚ğŸ˜‚ğŸ˜‚ğŸ˜‚	Abusive/Offensive	3.0
<A/O> bc <A/O> bari hai wo mersy	Abusive/Offensive	3.0
Ab kisi nay demag ki dahi kii na tu block krdoga <U> bc <U>	Untargeted	3.0
RT : <U> bc <U> is tweet ki reach hi dead ho gai ha :(	Untargeted	3.0
<A/O> is namoony <A/O> ko k comm list mein announce kia gya hai aur <A/O> is bc <A/O> ka 1 tweet nhi PSL k baare mein	Abusive/Offensive	3.0
Sb ratings ka mamla hai, is ko b meera ki trha news main rehna hai bs <U> bc <U>	Untargeted	3.0
Wow english <U> Bc <U>	Untargeted	3.0
<U> Pappu gaya gaand marane. <U> Iss baat mein Pappu kahan se aaya. <A/O> BC tum gadhe ke bachcho <A/O> ko Pappu ke alawa kuch dikha hi nahi ğŸ¤¦â€â™‚ï¸	Abusive/Offensive	4.0
<U> Bc <U> kesi pitch h yh	Untargeted	3.0
Yeh kal mery dm ma vn ka option aya tha... aj show ni ho raha... <U> Bc <U> masla kiya ha ?	Untargeted	3.0
this lab is about to make me drink this entire case of beer tonight bc Iâ€™m fed up	Neutral	0.0
i broke my tailbone and lemme tell ya...it takes months to heal! i am just now getting better!! just be gentle to it! itâ€™s gonna suck not skating super hard like usual but heal it as quick as you can bc fallling after itâ€™s almost done healing starts it all over again lmaoğŸ¥´	Neutral	0.0
Haha chay wali <A/O> bc <A/O> ki nql ki bat kr rhy. <A/O> Lnt tere jman ty v <A/O> ğŸ–ğŸ»	Abusive/Offensive	3.0
bc he's right next to me rnğŸ˜•	Neutral	0.0
u think i wonâ€™t kms bc i hate my haircut?	Neutral	0.0
Jineyyy mera dil luteya, oh <U> bc <U> yeh kiya hogya.	Untargeted	3.0
Wo <U> bc <U> bach jaty hen ğŸ˜·ğŸ˜·ğŸ˜·ğŸ˜·	Untargeted	3.0
<U> Bc <U> aik khaadi ka dress lai kar poori uni mai shopping bag ghoomana band kro	Untargeted	3.0
Ab yehi <A/O> bakwas karni thi tu ne bc i know u meri gandi oladğŸ˜‚ğŸ˜‚ğŸ˜‚ğŸ™Š <A/O>	Abusive/Offensive	5.0
<A/O> Saly chutiye <A/O> baqi pore Pakistan me kahin covid nahi ha. Sirf cricket me ha. <A/O> Bc tum logo ko na fire mar dena chahe ha sedha <A/O>	Abusive/Offensive	5.0
Baber.. Look <A/O> bc <A/O> this is the difference between you and Kohli. Get over it. You just can't play 60 off 50 knock in T20 Mate, do something.. ğŸ™ #BaberAzam #KKvsIU #PSL	Abusive/Offensive	3.0
Umpire andha ho gya hai <U> bc? <U> wasn't that wide?	Untargeted	3.0
<U> Behnchod <U> 4 overs reh gy hn. Use your feet against nabi. <A/O> Wickets gaand me le ker jani hn bc <A/O>	Abusive/Offensive	5.0
depends on when bc i gotta work!	Neutral	0.0
Too too much ghtya to tell ....bht <U> bc <U>	Untargeted	3.0
RT : Pakka fix hai <U> bc. <U>	Untargeted	3.0
<A/O> Faheem bc <A/O> kabhi Pakistan team me bhi aisa khel liya kar.	Abusive/Offensive	3.0
RT : Pakka fix hai <U> bc. <U>	Untargeted	3.0
<U> Dur fitay mu bcğŸ˜‚ <U>	Untargeted	3.0
Same lekin ye Beauty ni hy bhayiiii bht buri chubhti hy ye milty hue <U> bc <U> ğŸ¤¦â€â™‚ï¸	Untargeted	3.0
Raise your voice against men in Aurat March bc why don't they have this ğŸ”¥	Neutral	0.0
jhoot hai ye, mai ny bhi yahi soch kr earning start kri aur jo thi wo bhi chli gyi mtlb ajeeb <U> bc <U> ğŸ’”	Untargeted	3.0
RT : Bas kardo ni use karna mujha <U> ya bc tweeter <U> khuda ka wasta ha ya nottification band kro ğŸ˜­	Untargeted	3.0
Boss <U> bc <U> ki suno warna ghr bethoğŸ¤§	Untargeted	3.0
tu pehle pait kam kar apna <A/O> bc <A/O>	Abusive/Offensive	3.0
<U> Bc <U> tu car pe chor ata usko	Untargeted	3.0
<U> BC <U> aaj smjh aya k Islamabad United ka Name Manchester United ky tarz per rakha gya ! #PSL6	Untargeted	3.0
RT : <U> bc <U> garmiyaan agyi hain ğŸ˜‘	Untargeted	3.0
always, bc u r worth it to choose.	Neutral	0.0
<U> Bc <U> neend aa rhi hotii ha ik dum sa uss ki yad aa jati ha	Untargeted	3.0
ğŸ™„ğŸ™„ğŸ™„ğŸ™„ja <A/O> bc galiyaan suny gi <A/O>	Abusive/Offensive	4.0
Hahahah <U> bcğŸ˜‚ <U>	Untargeted	3.0
udhr multan haari idhr hum dosto mai ladai hogyi isi bat p fek <U> bc <U>	Untargeted	3.0
<A/O> Bc <A/O> aj tu gusy sy mar rha tha	Abusive/Offensive	3.0
<U> Chutiya n BC <U> are feelings not galiâ™¥ï¸ğŸ¥º	Untargeted	5.0
<U> Bc <U> goli mardun ga khud ko. Can't see these together outside Barcelona.	Untargeted	3.0
The matter is proceeding before ATC, not labelling them â€œ allegedâ€ would mean that the BC has accepted them as perpetrators and thus the ATC wud tooğŸ˜Š	Neutral	0.0
Congratulations PZ walon ğŸ™‚ğŸ’” Sohail Tanveer <Rel> Qayamat waly din tera alaida sy he hisaab hoga bc <Rel> #PZVMS #PSL6	Religious	5.0
<A/O> Bhut bc log ha <A/O> ğŸ˜…	Abusive/Offensive	4.0
Andhi billi se kya decode kru <U> bc <U> maiğŸ¤§	Untargeted	3.0
<U> Bc <U> click bait... Anything for views	Untargeted	3.0
agar sari bowling slow slow krwani ha to mujha bhi psl ma khilao <U> bc <U>	Untargeted	3.0
Tujhsy <U> bc <U> type to sahi sy ho nhi raha ğŸ˜‚ğŸ˜‚ baatin dekho	Untargeted	3.0
<U> Bc <U> kushi	Untargeted	3.0
I <U> FUCKING <U> HATE THESE CLASS NERDS <U> BC <U> KON 20 PAGES KI REPORT BANATA HA? WHEN PROFESSOR CLEARLY SAID 10 PAGES ARE ENOUGH? QABAR ME LY KR JANA AB.	Untargeted	4.0
<U> bc <U> garmiyaan agyi hain ğŸ˜‘	Untargeted	3.0
Koi hmari b krdy <U> bc <U> ğŸ˜‘	Untargeted	3.0
Hahaha <A/O> lanat hy bcğŸ˜‚ <A/O>	Abusive/Offensive	4.0
Tery mast mast 2 nain mery dill ka ly gye chain.. <A/O> Taqi tu bc pathan hy <A/O> or tu nainu py londy bazi na jhaar	Abusive/Offensive	4.0
You ever opened a msg and think, <U> 'BC..! <U> ab iss ko reply kiya du?'	Untargeted	3.0
Sbko nkaal dn gn tw <U> bc <U> khlyga kia moin khan	Untargeted	3.0
When you post a sad status on whatsapp. Le Friends: â€œArey bhai kya howaâ€? <U> Bc* <U> wesay nehi lagaa sktay kya status?ğŸ˜	Untargeted	3.0
Welp logged onto rust today and welp that game is ruined bc of my graphics card to... what a great day Iâ€™m having	Neutral	0.0
<U> Bc <U> razaii moo ty ly k bol reya.... ğŸ˜‚	Untargeted	3.0
Karachities k rt group mast hn <U> bc. <U> <A/O> Tatti tweets ko bhi utha k rkhty hn. <A/O> Lol	Abusive/Offensive	4.0
Lol qalundars k b achay din agye <U> bc <U> hamary kab ayengay	Untargeted	3.0
<U> BC <U> sarfaraz is over reacting.	Untargeted	3.0
Yrr <A/O> koi chwal frustrated insaan h bc <A/O> sb ko lar ra h <A/O> ye chootiya. <A/O>	Abusive/Offensive	5.0
Aur uper se catch b ....in no man land <U> ....bc <U> ğŸ¤£ğŸ¤£ğŸ¤£#qgvlq	Untargeted	3.0
Jo kachra <U> bc <U> Quetta walon ne akhta kia hua..ahmad shehzad, umar akmal se Jan chuti per anwar ali pechy pra or oper se shinwari ly lia	Untargeted	3.0
<A/O> Bc <A/O> kitna gussa kr rha sab pr	Abusive/Offensive	3.0
<U> Bc <U> to merey janazy par aae main wasiyat kr k jaon ga kh palwasha ko teendy khelany busğŸ¤£	Untargeted	3.0
<A/O> Yeh bc <A/O> mery mind MN ghusny ka name nahi leti ğŸ™„	Abusive/Offensive	3.0
Maine bhi vhi bola <U> bcğŸ˜‚ğŸ˜‚ğŸ˜‚ğŸ˜Š <U>	Untargeted	3.0
<A/O> Skipper Match kharaaaab kr gyaaa BC <A/O> ğŸ˜ğŸ˜ğŸ˜¡ğŸ˜¡ğŸ˜¡ 21 (26balls) LQ 64-1 in 8.4 Overs Need more 115 from 68 balls ğŸ§ğŸ§ #LQvQG #HBLPSL6 #MatchDikhao	Abusive/Offensive	3.0
Kia khoob gugli kia <U> bc <U> kia commentary hai #LQvQG	Untargeted	3.0
Dressing room mein LQ walay bol rahy homgay kia <U> bc <U> why even bother ab bahar jakay acting krni parhegiğŸ¤£	Untargeted	3.0
Tunay mujhy mana na kiya hota na <A/O> bc <A/O> to btata ğŸ˜‚ğŸ˜‚ğŸ˜‚	Abusive/Offensive	3.0
Mota hai lekin <U> bc <U> thokta pura hai	Untargeted	3.0
Wahh <U> bc <U> ye to teri janny wali nikal ai	Untargeted	3.0
Hahahhaha <U> bc <U> knsa taras	Untargeted	3.0
<U> bc <U> pornstart ka name ap se poch lo ap pura uska khandan ka nam bta dy gy pakistani logo ka nam yad nhi apko	Untargeted	3.0
<U> Bc <U> out ğŸ¥º #LQvQG	Untargeted	3.0
<A/O> BC BEGARAT <A/O> ğŸ™„ğŸ™„ğŸ˜œğŸ˜œ	Abusive/Offensive	3.0
Pta nhi <U> Bc <U> id nhi chal rhi thi ğŸ˜­ğŸ˜­	Untargeted	3.0
Hn ye b depend krta hai...our teacher teaches like...han to ye b apko pta hoga ye b apny phly prha hua...like <U> bc <U> agr sb ata hai to phr hum yaha kya krny aye hai	Untargeted	3.0
<U> Bc <U> ek to ye roz roz ka sar dard	Untargeted	3.0
heecore bc of ur layout	Neutral	0.0
RT : I overwork myself bc I love distractions	Neutral	0.0
I overwork myself bc I love distractions	Neutral	0.0
ye Sab he single hain to <U> bc <U> relationship mein kaun hai bai? ğŸ˜­ğŸ˜­ğŸ˜­	Untargeted	3.0
I love the fantasy that this brings Bc we all know he canâ€™t grow a beard like that ğŸ¤£ğŸ¤£ğŸ¤£	Neutral	0.0
Achaw me smjha beera chikna h ğŸ˜­ğŸ˜­ğŸ˜­ğŸ˜‚ğŸ’” <U> bc <U> isi lye me single ğŸ˜­ğŸ˜­	Untargeted	3.0
<U> Bc <U> ye love triangle kya hota hai??	Untargeted	3.0
Ge likha kar gay ne likha kar <A/O> bc tu <A/O> ğŸ˜‚ğŸ™„	Abusive/Offensive	3.0
Fuq this yaar <U> bc. <U>	Untargeted	3.0
Hum konsa Oxford graduate hain <U> Bc, <U> ğŸ¤¡	Untargeted	3.0
<A/O> Lakh di panat pitch curotor par <A/O> Agar itna he bat n ball contest dekhna hai tou test dekho choro psl <A/O> BC <A/O>	Abusive/Offensive	3.0
<A/O> Ja bc knhi doob ky mr ja knjar <A/O>	Abusive/Offensive	5.0
dekh bahi mujhe nahi sunna ke tumne uber chalana kese shuru ki aur tumhari yey real job hai ya nahi hai. chup chaap manzil pe pohncha apun ko <U> bc <U> ğŸ˜«ğŸ˜«	Untargeted	3.0
Multan Ki Team Hai He Ghatiya <A/O> Hr Baar Bakwass Team Or Bakwass Captain Banaty Hain Ye BC <A/O> Test Khelny Aya Hai kia ? <A/O> Lanat Ho Aysi Management pr 100 Baar Lanat <A/O> Hr Baar Afridi K Sath Injustice Kyn ğŸ˜ ğŸ˜ ğŸ˜ ğŸ˜  #IUvMS	Abusive/Offensive	5.0
Yah <U> bc <U> kiaa chez hai yaar	Untargeted	3.0
<U> Bc <U> dooor	Untargeted	3.0
<A/O> Chal bagh bc <A/O>	Abusive/Offensive	4.0
In sub ko lgta k <A/O> ya bc <A/O> intellectuals han, bahsan danay aty, constructive criticism nai kr skty	Abusive/Offensive	3.0
43 <U> bc <U> doctor bhi tha banker b tha siyastdan bhi tha hahhahhhahahahaha	Untargeted	3.0
Goal krooo <A/O> bc <A/O>	Abusive/Offensive	3.0
<A/O> O bosdk <A/O> .. <A/O> teri gandd m idli dose pelu bc <A/O>	Abusive/Offensive	5.0
<A/O> Umpires nashe mein hain kia ? <A/O> 1 ball rehti hai <A/O> bc <A/O>	Abusive/Offensive	4.0
<A/O> BC Umpire <A/O> ğŸ˜ 	Abusive/Offensive	3.0
<A/O> BC 3rd Umpire Andhaaaaa he lgtaa <A/O> ğŸ™„ğŸ™„ğŸ™„ğŸ™„ vs #HBLPSL6	Abusive/Offensive	4.0
No offence but i hate these type of people, or ham yaha paani peetei <U> bc <U> weight barh jatağŸ˜­ğŸ˜­	Untargeted	3.0
<U> O BC <U> challliii gaeee Bijliiiii ğŸ˜ğŸ˜ğŸ˜	Untargeted	3.0
<U> 1 tu BC <U> Yeh per Live Match kmmm or Advertisements Zyadaaa chalti hain ğŸ˜ğŸ˜ğŸ˜ğŸ˜ğŸ˜ğŸ˜	Untargeted	3.0
OUTTTTT <U> BC <U> YAYYYY!!!! #LQvPZ #PSL6	Untargeted	3.0
I say â€œokâ€ bc i donâ€™t feeI like arguing but that doesnâ€™t mean ur right though	Neutral	0.0
<A/O> #geochor <A/O> Yah hai aam Zindagi: <A/O> #BC #MC <A/O> Or yah hai mentos Zindagi: <A/O> #GC I mean to say #geochor <A/O> ğŸ˜ğŸ˜ğŸ˜	Abusive/Offensive	5.0
<A/O> Bc International Macthes main kiaaa mooooot aa jati he <A/O> jb aisi balls ko chooor daitey hoo...	Abusive/Offensive	4.0
<A/O> O bc ab b jhot bhonk raha h or kitna bhonky ga jhot <A/O>	Abusive/Offensive	5.0
<A/O> bc tu to iski joti jesi b ni hai <A/O>	Abusive/Offensive	4.0
Rameez raja k mazy hn <U> bc <U> larkio k sath hi khada hota ha	Untargeted	3.0
I could wait months for your writing Bc it will be worth it ğŸ’š	Neutral	0.0
Stop tweeting happy weekend shit <A/O> bc <A/O> 1 : It doesn't matter 2 : I've class to attend tomorrow 3 : <A/O> Fuck you <A/O>	Abusive/Offensive	4.0
Imran khan is choro ko q nhi pkrta <A/O> bc <A/O>	Abusive/Offensive	3.0
If two people look happy together, let them live. <U> Bc <U> Phupho na ban jaya Kro ğŸ¤¡	Untargeted	3.0
bhai full paisay kharachna ka mood ha mgr <U> bc <U> tapmad subscribe hi nhi horha. error aa rha ha	Untargeted	3.0
It was just a guess bc if terras on a team, they have to have a good coach. Sheâ€™s just that high talent of a player that she demands high level coaching.	Neutral	0.0
Abhi tak nhi hua masla hal Tum loog network bnd hi krdo ğŸ˜¡ğŸ˜¡ <A/O> Bc <A/O>	Abusive/Offensive	3.0
<A/O> Bc <A/O> dia tu ha tujy	Abusive/Offensive	3.0
RT : We all know that 2021 isn't going to be any better just bc the calendar changed but if you delete those toxic text threadsâ€¦	Neutral	0.0
Koi phone cheeno iska <U> bc <U>	Untargeted	3.0
<A/O> Bc <A/O> isko dekh ke bhi tera dimag gandi side pe jatağŸ˜­	Abusive/Offensive	3.0
Yar 2 min reh gy hn, link du <A/O> bc? <A/O>	Abusive/Offensive	3.0
Ek tarf <A/O> Karachi bc <A/O> aur dosri trf <A/O> sarfaraz bhosri wala <A/O>	Abusive/Offensive	5.0
<U> Bc <U> I don't even have a laptop. Ap phone pe match dekhon ga ya tweets krn ga :(	Untargeted	3.0
Fireworks at National Stadium Karachi. <U> Bc <U> ceremony bhi krwa hee dete yahien pr. Adhay ghantay ki ceremony k liye fazool turkey gaey hain. #PSL2021 #PSL6	Untargeted	3.0
<A/O> Bsdk <A/O> content chori krty ho upar sy badmashi dekhaty ho.. Morro ny jab yeh vlog bnyaa us ny mediaa par chlany k lyee bolaa tab tum logo ny pasy mang lye... Un ratinh mil rahi hy tu chori ka mall chapkaa rhy ho.. <A/O> Lanat bc tum logo par <A/O>	Abusive/Offensive	5.0
<A/O> bc <A/O> hath nai ponch raha to <A/O> kutton ke trha bhaonkna shuro kr deya gd keep barking <A/O>	Abusive/Offensive	5.0
Just bc I love cancerians	Neutral	0.0
Kia kar le ga tu ? <A/O> Bc <A/O> dhamkian kisi aur ko de	Abusive/Offensive	3.0
<A/O> Bc Indian Serial Followers <A/O>	Abusive/Offensive	3.0
Prh le <A/O> bc <A/O>	Abusive/Offensive	3.0
<A/O> LPC. BC <A/O>	Abusive/Offensive	4.0
Ma ny kya kiya <A/O> bc <A/O> ğŸ˜ğŸ˜ğŸ˜ğŸ˜	Abusive/Offensive	3.0
<A/O> Bc chudwai krwa k bhool b gyğŸ˜ğŸ¤£ <A/O>	Abusive/Offensive	5.0
Perks of being in my life If we get in a fight Itâ€™ll only last a day bc by the next day Iâ€™ll forget we were even fighting ğŸ™ƒğŸ™‚ğŸ™ƒ why am I like this	Neutral	0.0
BRO THATS NOT HIS BACKGROUND AND IM SO SAD BC I KNOW WHOS BACKGROUND THAT IS AND SHE WILL NEVER BE MINE ğŸ˜­ğŸ˜­	Neutral	0.0
<U> Bc <U> aik seat ka election sambhala ja nae raha...pata nae kia kia fraud kiye honay 2018 ma	Untargeted	3.0
<A/O> Marja bc <A/O>	Abusive/Offensive	3.0
Dude growing up during lent was a struggle for me bc I donâ€™t like seafood period... Iâ€™d just starve on fridays lmaooo	Neutral	0.0
<A/O> BC <A/O> likh ke sath badtamizi likhna or badtamizi likhna tha to <A/O> BC <A/O> na likhti	Abusive/Offensive	3.0
Bas kardo ni use karna mujha <U> ya bc tweeter <U> khuda ka wasta ha ya nottification band kro ğŸ˜­	Untargeted	3.0
<A/O> goli mar do bc <A/O>	Abusive/Offensive	5.0
<U> Bc <U> apny aap ko takrein maarni chahiyeğŸ˜‚	Untargeted	3.0
haina same wesy <U> bc <U> inko hum yaad nhi atyâ˜¹ï¸	Untargeted	3.0
<A/O> goli mardo bc <A/O> itna gusa ata hai	Abusive/Offensive	5.0
<A/O> tum sb ka cut jy ga bc <A/O>	Abusive/Offensive	4.0
Worst photos <U> bc <U> meri itni gandi lagayi thi jahaz bana hua tha mein	Untargeted	3.0
<S> Riyasat khassi h bc <S>	Sexist	5.0
I hate this emoji phir tu yehi emoji bhej de <A/O> bc <A/O>	Abusive/Offensive	3.0
This is unfortunate. Bas <A/O> jal jal k mar jaenge bc k inki auqat nahi hai tou koi aur kiyun shine karey. <A/O> <A/O> Fucking asses <A/O>	Abusive/Offensive	4.0
<A/O> Bc pagal ho gyi hai bjp <A/O>	Abusive/Offensive	4.0
Bilkul fr rat bhr neend nae ati <U> bc <U>	Untargeted	3.0
Donâ€™t agree , follow some of your quotes/ bc of that am happy feet .	Neutral	0.0
They always visit green planets Bc Rey loves them	Neutral	0.0
Har wqt khana. <U> Bc <U> pheelings kidr kry woğŸ™„ğŸ˜‚	Untargeted	3.0
<A/O> Is khotey ki apni kia shanakhat hai koi is se yh to pouchey. <A/O> <A/O> 2 takey ka nauker hai yh khud bc <A/O>	Abusive/Offensive	5.0
they deactivated ig <U> bc <U> i can't find their acc.. ğŸ˜’ weirdo	Untargeted	3.0
kyoun k rishtedar bhi hamare hotay hain <U> bc <U> !!!!	Untargeted	3.0
Crying bc that is exactly your response lmfaooo we luv to see it ğŸ˜—	Neutral	0.0
Lekin har dafa humare sath yuh e hota ha Phir ye line yaad aa jati <U> Duni bari BC <U> always tryna dodge me ğŸ’”	Untargeted	3.0
Kia faida <U> bc gndi krwny ka. <U>	Untargeted	5.0
Since her incarceration, the platform (belonging to the CitizenGO Group) has fought for her freedom, supporting her family and channeling the economic aid of thousands of citizens to defend this Christian mother.	Neutral	0.0
<A/O> Lanat teri soch aur mindset pe ullu ki pathi <A/O> apni tweet ka reply dekh...tu khud kya kr rhi idhr <A/O> PhD kr rhi thrk mai... <A/O> <A/O> Bay ghairat <A/O> khud bni hy ilzam mujhy...mai ne tera rishta maang lia kya Kia baat ki shrm... <A/O> Bastard bitch... <A/O> behave or complain for blocking u... silly	Abusive/Offensive	5.0
<A/O> thieving bastard <A/O>	Abusive/Offensive	3.0
Where is <A/O> bastard Ali moh khan <A/O>	Abusive/Offensive	3.0
ur my biggest opp now <A/O> bastard cunt <A/O>	Abusive/Offensive	4.0
Look at the tampering .. <A/O> you bastard's <A/O>	Abusive/Offensive	3.0
Lol, babe, Pakistani can't go to Israel <A/O> this bastard is telling the lie. <A/O> And where is the proof?ğŸ˜˜. <A/O> I show you the daddy Pervaz musharaf video!. <A/O> Where is nawaz Sharif video with Israeli ğŸ¤”?. Or Jewish.	Abusive/Offensive	4.0
<A/O> Rana Sana Ullah is a bastard!! <A/O>	Abusive/Offensive	3.0
Aby yr macharo ko need nh ati? <U> Bhen chod <U> ğŸ˜ 	Untargeted	3.0
I have a masoom face with <U> bhen chod dimag <U> and also bth gandi zuban which totally destroy my personality ğŸ˜‚ğŸ¤£	Untargeted	3.0
Imran khan sb raleaf ko chody istifa daidy mehrbani hogi app ki	Neutral	0.0
Hahaha <A/O> jo khud sari raat gand marwata hy vo mjhy chody gaa <A/O> ğŸ˜‚ğŸ¤¦â€â™‚	Abusive/Offensive	4.0
Lahore Qalandars Move on Finished hai fakhar zaman Kash na karta Bumrah No ball Choot jaati hamari Jaan. #MSvLQ #PZvQG #MatchDikhao | #HBLPSL	Neutral	0.0
Ã€j ki choot di ha	Neutral	0.0
Allah n kre asa ho ğŸ˜‘ğŸ¥º Dekh sir p choot lgne k bd bh sb kch bhool gya m but treat abh tk yad hğŸ™‚ğŸ˜’ğŸ˜‚	Neutral	0.0
ni mushkil ni agar apni life ka aim fix kar lo to sab koch khudi pechy rah jata hi or choot kha kar insan mazbot ho jata hi ... or ma strong ho cuki hon	Neutral	0.0
Qalandars me 2 trah k players han. Aik vo jis k hath pr choot lagne k baad bhi 100% de rha dosra vo jis k hath theek hone k baad b catch ni pakray jaa rhay.... #LQvQG #PSL2021	Neutral	0.0
Han yar mind ko distract kar lo sab kuch choot jaye ga Btw subcontinent ki mitti mein aadat kisi cheez ki hona aam si baat ha qk idher logo ki soch mehdood ha	Neutral	0.0
Janab PM Sb! Kuch performance ground level per show karen ab sirf baaton se kaam nahi chalna. Dusri surat men train choot jayegi.	Neutral	0.0
<A/O> Teri man ki choot <A/O>	Abusive/Offensive	4.0
<A/O> Lpc gandu <A/O>	Abusive/Offensive	4.0
<A/O> Tery man baap tuj janam de k pachtaty hon gy gandu <A/O>	Abusive/Offensive	4.0
Kiss chez ki sfaii dy rha h?? <A/O> Is gandu <A/O> ko main kya smjhta hun mery mulk me mzdori krny wla ek shks is sy lakho guna bhtr hai?? <A/O> Ma chudwyn sub jo mrzi jis mrzi zuban me bolyn <A/O> mery voot sy nahi ay ye!!	Abusive/Offensive	5.0
<A/O> Ajeeeb gandu bnda hai <A/O>	Abusive/Offensive	5.0
<A/O> Cutest gandu <A/O>	Abusive/Offensive	3.0
<A/O> Gandu king <A/O> ka agay jana bnta bhi ni tha.	Abusive/Offensive	3.0
<A/O> Gandu <A/O> req accept kr	Abusive/Offensive	3.0
<A/O> Gandu <A/O>	Abusive/Offensive	3.0
<A/O> Han bai barwe <A/O> phadde karega bharam ha? <A/O> Launde layega hat gandu <A/O>	Abusive/Offensive	5.0
<A/O> Lanat tum logoun or is gandu punjab k wazir-e-ala pr. <A/O> Mara kisne hy iski bat bad me hogi pehly ye bat hogi k hukmran kon hy?Intazamiya kiski thee? Zumahdar kon hy?Tum log!Mary koi bhi tum <A/O> adam khor syastdanoun <A/O> ko is se kya?Ab jab tak mujriman ko latka na do <A/O> bakwas na krna dobarah! <A/O>	Abusive/Offensive	5.0
Now I feel sad ğŸ˜¤ğŸ’”ğŸ˜’ thank You <A/O> Sohail Gandu Tanvir <A/O>	Abusive/Offensive	3.0
itni lutt nai machi hui wo din gaye jab <A/O> Russell gandu <A/O> jeetwa deta tha.	Abusive/Offensive	3.0
RT : dil hai toota <U> gandu hain ham <U>	Untargeted	3.0
<A/O> meri uni waly gandu <A/O>	Abusive/Offensive	3.0
<A/O> Gandu ha to <A/O>	Abusive/Offensive	3.0
Ab sun be ujade <A/O> chaman chutiye lode pe latak ke bakwas mat kr wena teri esi esi choduga k gandu fir se gyan jhade ga sala chutiya <A/O> <A/O> ..apne baap se kese baat krte hai sikha nh teri kity mom ne <A/O>	Abusive/Offensive	5.0
han kuch <U> gandu <U> bhi hoty hain	Untargeted	3.0
Bry bry main yaq dekhy par ye jo shafat me haina wo kya <A/O> kmal k gandu hain <A/O>	Abusive/Offensive	4.0
Chek it <A/O> mary payary gandu <A/O>	Abusive/Offensive	3.0
<Rel> Gittya Harami Mirza <Rel> tayra Pura tubbar Chor be Ha aur <Rel> Harami be Ha shahkal Dekh kabi apni <Rel> #	Religious	5.0
<Rel> Bry harami hu <Rel> betağŸ˜‚ğŸ˜‚ğŸ˜‚	Religious	3.0
Lagta ha <U> bohat harami <U> dost hnğŸ˜‚	Untargeted	3.0
Or teea bap or teea handan bich me <Rel> tu haramkhor b sab se baray harami ho <Rel> ğŸ˜‚ğŸ˜‚ğŸ˜‚ğŸ˜‚ğŸ˜‚	Abusive/Offensive	4.0
<Rel> Ha hi harami ha log <Rel> ğŸ˜ğŸ˜‚ğŸ˜‚	Religious	3.0
<Rel> F a t f waly b bht harami hn <Rel>	Religious	3.0
Ye koi londa hy ğŸ¤¡ in sub main sy Koi. ğŸ˜‚ <Rel> Ye sub harami hain <Rel> ğŸ¤£	Religious	3.0
<Rel> Harami londy <Rel>	Religious	3.0
<Rel> Sale suvar amir tune apni gandi mazhabi aukat dikha di..yehi sikhata hai tumhe tumhari ashmani kitab aur madrasa <Rel> .... <Rel> harami teri maa ka bhosda tere ma ke chut mai mera lund ....tum sab ke maa pe suvar chade honge tab jake tuumhare napaak kaum paida hui <Rel>	Religious	5.0
You think you have met a harami person but no you are gonna meet a more harami person and the loop goes on	Neutral	0.0
<Rel> Ye shugli faraz pka harami ha <Rel>	Religious	3.0
RT : <Rel> Parwaiz nami harami <Rel> or tu tum sab ka Pakistan sy kia layna daina hy hum tumhaein kisi layak nahi samajhtaâ€¦	Religious	3.0
PPP ne bhutto ki qbr k paisy wahan lgaye thy na <Rel> saalaay harami <Rel>	Religious	3.0
<Rel> Tu to wohi harami ha <Rel> na joo blochistan alag karne ki baat kar rha tha <Rel> khanzeer <Rel>	Religious	3.0
<Rel> Ye harami ha <Rel> mam	Religious	3.0
pakistan aa ke <Rel> yeh bakwas kr harami <Rel>	Religious	4.0
Without any doubt <Rel> you are most cheap ever Gittya and Harami person and you proved it. <Rel> <A/O> Tum per Dur Fittay Moun tou Banti ha Amir Liaqat# <A/O>	Religious	5.0
<Rel> Yeh harami hain <Rel> inko heal nhi waqti feel chahiye hoti.	Religious	3.0
Well said.......But awam ko phir b shaur ni ana sab kuch janty huye b har koi apni dhun m mast ha aur <Rel> harami politicians <Rel> maal bnane m jaisi awam waise hukmran	Religious	3.0
describe your <Rel> â€harami friendâ€ <Rel> in one line ?? ğŸ‘€	Untargeted	3.0
Others: One word for your best friend Me: Masoom face with <Rel> harami mind <Rel> ğŸ˜’ #sR	Untargeted	3.0
<Rel> Some harami Pakistanis <Rel> are in the audience ğŸ˜‚ğŸ˜‚ğŸ”¥	Religious	3.0
<U> Hormons ka harami pnğŸ™‚ <U>	Untargeted	3.0
<Rel> Bare harami ho beta <Rel> ğŸ˜‚	Religious	3.0
<Rel> Bara hi harami h <Rel> ğŸ˜‚ğŸ˜‚ğŸ˜‚	Religious	3.0
<Rel> Bara ho kr or harami bany gağŸ˜‚ <Rel>	Religious	3.0
<Rel> Lanat harami <Rel>	Religious	3.0
Sbhe tareef k layak log khandan main harami nahe hotay ğŸ˜‚	Neutral	0.0
Pora khandan js ki tarefyn krta h <U> Wohi sb sy bra harami hota h <U>	Untargeted	3.0
<Rel> Patwario ki tu 1 he nasal ha harami nasal <Rel>	Religious	4.0
Ub <Rel> ye harami <Rel> kon h	Religious	3.0
Good one jitna tu ghista shayad hi koi ghista ho <Rel> harami <Rel>	Religious	3.0
Aisi Pix Bananay Say Kisi Ko Bhikari Declare Kar Saktay Ho? Aisay To Main <Rel> Tumhary PM Ko Harami Declare Kar Sakta Hun <Rel>	Religious	3.0
RT : I'm tired of being cute with everyone, i need to show my andar ka harami now	Neutral	0.0
<Rel> Harami hamesha harami hi rahta hai qatri khoti ka dalal <Rel>	Religious	5.0
<U> Log boht harami ha:/ <U>	Untargeted	3.0
<Rel> Oooo harami chup kar <Rel> win pti i love u ik	Religious	3.0
"In urdu.wo don't say, you are so naughty. We say, ""bady harami ho beta"" i think that sounds good.ğŸ˜‚"	Neutral	0.0
<Rel> Gulam harami abi be zinda hai <Rel>	Religious	4.0
O wish I could see the face of <Rel> Barking dog Shahbaz gill Harami <Rel> #VoteNawazKa	Religious	5.0
<Rel> Kaisay Kaisay Harami Journalist Hissay Main Aye Hain Pakistan Kay....!!! <Rel>	Religious	4.0
<Rel> Harami <Rel> jata phir bh tha ğŸ˜‚	Religious	3.0
<Rel> Bht harami ho beta <Rel> ğŸ˜’ğŸ¤£	Religious	3.0
<Rel> Ghadar waton faroosh Harami qatri khoti party <Rel>	Religious	5.0
MERI IZAT ROLNA BAND KAR <Rel> HARAMI <Rel>	Religious	3.0
ğŸ˜‚ğŸ˜‚ğŸ˜‚ <Rel> nikkl harami <Rel>	Religious	3.0
Zbn btati koun Harami koun Halali	Neutral	0.0
<Rel> Tum 3sa harami is Puri duniya mein Nahin hai <Rel> koi choto kar âœŠâœŠ	Religious	4.0
janab yaha to ese larke larkiya bhi hen jin ki timeline full islami hoti he or Dm me wo full harami hote hen ğŸ˜„ğŸ˜„	Neutral	0.0
Grey list me dalwaya <A/O> kis kanjar ne tha ? <A/O>	Abusive/Offensive	3.0
Fawab sahb yahan pe <A/O> kanjar khana bna howa hy pakistan. <A/O> Jis ka ju dil chahy kar leta hy. Chor kheta hy chori k bad mje kuch ni khena. Qatil kheta hy qatil k bad mje rehaa kar do.	Abusive/Offensive	3.0
Janab awam ko Spotify nhi chye Awam ko PayPal chye Awam ko Stripe Chye Awam ko Amazon Chye Awam Ko Ap jesy IT Minister bilkul b nhi chye ğŸ™ please do something for digital Pakistan <U> sanu kanjar na bnao <U> Expert bnao ğŸ‘	Untargeted	3.0
<A/O> Kanjar e Azam <A/O>	Abusive/Offensive	3.0
aisy nhi kahon ge aisy kahon ge ya mein hon <U> ya meray kanjar yaar hain <U> or ya hamari barbadi ho rahi ha.	Untargeted	3.0
RT : And in my heart there lives a <U> pure kanjar insaan. <U>	Untargeted	3.0
<A/O> Chutiyape Sath betha kanjar <A/O> loyal ni hai Kosan dour betha khabees loyal ho ga Everything ğŸ’â€â™€ï¸	Abusive/Offensive	4.0
<A/O> Ghar bula lo aakar chod Jay ga bari aag lagi hoi hai kanjar k bachay <A/O>	Abusive/Offensive	5.0
<A/O> Hamid Mir kanjar ho. <A/O>	Abusive/Offensive	3.0
<A/O> Awla darjy k kanjar ho <A/O> k bhi aesy act karty hein in se acha koi nahi ğŸ’â€â™€ï¸	Abusive/Offensive	3.0
Ignored too many achy log because of only one <U> kanjar. <U> ğŸ’â€â™€ï¸	Untargeted	3.0
<A/O> Tum hogay kanjar kevin 11 k mun walay <A/O>	Abusive/Offensive	3.0
Yah Kiya <U> Kanjar Khana Ho Raha Ha <U>	Untargeted	3.0
Haan. I'm from punjab,nd I can't tolerate any sarcasm against my sindhi brothers. Sack that <A/O> kanjar bhatti <A/O>	Abusive/Offensive	3.0
<A/O> Kanjar khoti k bachy k <A/O> hty jo serious ho jatayğŸ¤®	Abusive/Offensive	3.0
Why <A/O> 8ndians are so kanjar <A/O> ğŸ˜‚ğŸ˜‚ #IndiaWithModi #PSL6	Abusive/Offensive	3.0
<A/O> Khandanii Kanjar <A/O> LoL	Abusive/Offensive	3.0
<A/O> Ithe sab kanjar aa, <A/O> manda koi nahin.	Abusive/Offensive	3.0
<A/O> Kanjar, dalal N league ka <A/O>	Abusive/Offensive	5.0
<U> Karma is a kanjar <U> aint it	Untargeted	3.0
<Rel> Usman buzdar or cabinet ko chahiye k resign dy or dfa ho jaiy kahin jahanum m.. <Rel> In 2 bhaiyon k ghar pr aj kia beety gi. <A/O> Hmari kanjar govt <A/O> ko idea b h	Religious	5.0
<A/O> ajeeb kanjar log <A/O>	Abusive/Offensive	3.0
<Rel> Allah maf kry aisy phudi bchy tyqr hoty hai in talemi adaro me jhan burgra prhty!! <Rel> ğŸ˜†ğŸ˜† <A/O> wo kisi ko insna he nahi amjhty apny siwa <A/O>	Religious	5.0
<Rel> Wesy shia log me ha riwaj ha k koi banda shia larki ki phudi mary to uska qamar dard thik ho jata ha kya ye sach ha? <Rel>	Religious	5.0
Iâ€™ve got the best Sunni Friends â¤ï¸â¤ï¸â¤ï¸ AlhumduLillah Hum sub Molai Hein ğŸŒ¸ğŸŒ¸	Neutral	0.0
My Father and mother wr both Shia and Syed if your parents r 4rm the same sect your personality and mentally would b developed according 2 it but if your parents are 4rm different sects like one is Sunni other is Shia then u would b different person 4rm above mentioned person	Neutral	0.0
Tharr patker ma ubhi polling station ko aag laga di... News sunni hi janab ne yaa kanoo ma..... Thonsa hova hi?	Neutral	0.0
the Islamic revolution emboldened Sunni Islamist groups, galvanizing their followers into thinking that revolution could be possible elsewhere	Neutral	0.0
When Khomeini declared that â€œIslam was political or nothing else,â€ he was saying something that Sunni Islamists had themselves long said.	Neutral	0.0
Es banday sy job kay relivent kabi koe baat nai sunni. Kabi showbiz kabi politics.ğŸ˜	Neutral	0.0
Akhlaaqiyaat Ki Dhajjiyan Uraaney Waaley <A/O> Beghairat <A/O> Daikhney Hon To 90s Ke PPP Aur PML N Ke Jalson Ki Videos Daikh Lain..,Magar <A/O> Aapko Ko Kahaan Akhlaaqiyat Ki Samajh Aani Hey <A/O> Aap Logon Ke Aasaab Par To Imran Khan Charh Kar Daurh Raha Hey ğŸ˜‚ğŸ¤£	Abusive/Offensive	2.0
<A/O> Word: beghairat Synonym: meray dost <A/O>	Abusive/Offensive	2.0
Sir <A/O> iss beghairat <A/O> ko sharam nahi aye gi	Abusive/Offensive	2.0
<Rel> Tere sy bra beghairat jhoota hramkhor kisi maa ne ni peda kiya, <Rel> <A/O> laanti <A/O>	Religious	5.0
Means fraud pakra jaye ga tumhara ... <A/O> Kese kese beghairat dekhe hain <A/O> ğŸ˜…ğŸ˜‚	Abusive/Offensive	2.0
<A/O> Aap khud hi beghairat hain <A/O>	Abusive/Offensive	2.0
Urdu is such a beautiful language like <U> â€œbeghairatâ€ means bestfriend. <U>	Untargeted	2.0
PTI new tactic to delay polling Firing karao pehle, police ko bahana dou halaat kharab honay ka so that they can stop people from polling <A/O> Shame on you beghairat <A/O>	Abusive/Offensive	2.0
Today I applied dove soap on one side of my face and normal soap on the other side and you won't believe k meri kamar mai chapal mari meri mama ne or boli <U> beghairt <U> dono sabun aik sath khatam kry ga boht raaes hai tu <U> kuttay. <U> ğŸ˜£ğŸ˜£	Untargeted	2.0
ğŸ˜‚ğŸ˜‚ğŸ˜‚ğŸ˜‚dil ki tasali k liye ye song acha hai <U> beghairtğŸ˜‚ <U>	Untargeted	2.0
Tume izat ras hi nhi <A/O> beghairtğŸ˜‚ <A/O>	Abusive/Offensive	2.0
RT : <U> BeghairtoğŸ˜‚ğŸ˜­ <U> abh saray shuru hogaye hain	Untargeted	2.0
Asad chitta boht ha waise MA ğŸ’¥	Neutral	0.0
<A/O> Chal be bsdk <A/O>	Abusive/Offensive	4.0
<A/O> Bsdk <A/O>	Abusive/Offensive	3.0
Song h <A/O> bsdk <A/O>	Abusive/Offensive	3.0
Mana swiper ka bola to <A/O> bsdk <A/O> ka kia mtlb	Abusive/Offensive	3.0
<A/O> Bsdk <A/O> mtlb	Abusive/Offensive	3.0
<A/O> Chal bsdk <A/O> first of all tume ma block krta hun	Abusive/Offensive	3.0
<A/O> Bsdk <A/O> wo ganf nai mth thi	Abusive/Offensive	3.0
<A/O> Pehli fursat mein nikl bsdk <A/O>	Abusive/Offensive	4.0
<A/O> Tu chup kr bsdk <A/O>	Abusive/Offensive	4.0
Wo main lar lunga uski tension na le <A/O> tu bsdk. <A/O> <Rel> Pehle Tu aur Tere Jaise saare andh bhakt along with Ranga Billa gau mutr piye aur gobar khai Apne khandan walon k sath <Rel>	Religious	5.0
<A/O> O BSDK.... <A/O> ye mask hai <A/O> andhy.... <A/O>	Abusive/Offensive	4.0
<A/O> chl bsdk modi da chooste ho tum mc <A/O>	Abusive/Offensive	5.0
Bs kr dy <A/O> bsdk <A/O> ğŸ˜‚	Abusive/Offensive	3.0
Ya hai duniya yha kitny Ahad e Wafa Bewafa ho gaya <U> (bsdk) <U> dekhty dekhtyâœ¨ ( Ustad NFAK)	Untargeted	3.0
Yeh wohi hai jis sy Pakistani team ma 1 six ni lagta... <A/O> bsdk <A/O>	Abusive/Offensive	3.0
Tweet to sai wali rt kr lo	Neutral	0.0
<A/O> Bsdk isky muh per ball maro <A/O>	Abusive/Offensive	4.0
Shabash meri tweet rt karni ha	Neutral	0.0
Hahaha chalo Rt to kar sekty ho nağŸ˜‚	Neutral	0.0
Bhtr mily ...dua trsy ....bdua	Neutral	0.0
<A/O> Bsdk <A/O> full baat per baal de raha ha	Abusive/Offensive	3.0
M bola aksr log gussa krty ...m use krti y wrd	Neutral	0.0
Abi to acha h jysy ap reply krty m b kr dti is m kya burağŸ’«	Neutral	0.0
Wo bs kr diy kch	Neutral	0.0
<A/O> Nikal bsdk <A/O>	Abusive/Offensive	3.0
<A/O> Chup bsdk <A/O>	Abusive/Offensive	3.0
Isky Sath Ik Or option hota K 3no tu behter HotağŸ¤¬ <A/O> bsdk <A/O> ny mjy block kia howa hy	Abusive/Offensive	3.0
<S> Nikal oye bsdk may aaya tha tum ghar mrwany gai thy <S>	Sexist	5.0
Sochi pya ty bnda gya	Neutral	0.0
Hahaha sai h g ... mil jy to aik e rakhna phrğŸ˜‹	Neutral	0.0
Sai ki adat apko v ... m bht bolti aksr gusa krty is wrd p	Neutral	0.0
Barber: Sir is bar machine lgwani hy ? Last time to setting krwai thi.. Inner me: <A/O> Bsdk <A/O> 1st time aya hn tery passğŸ˜‘	Abusive/Offensive	3.0
Dm <A/O> bsdk <A/O>	Abusive/Offensive	3.0
<A/O> Kon bsdk isb ko support kr rahy hain? <A/O>	Abusive/Offensive	3.0
<A/O> bsdk... <A/O> zinda ha tu?	Abusive/Offensive	3.0
<A/O> Bsdk <A/O> tujhy to kuch ni kaha <A/O> ...phir teri Q jal rahi <A/O>	Abusive/Offensive	4.0
<A/O> Bsdk <A/O> angrezi tou thek se bol le	Abusive/Offensive	3.0
Song hy <A/O> bsdk <A/O>	Abusive/Offensive	3.0
<A/O> Bsdk sala <A/O>	Abusive/Offensive	4.0
Both if bdly m b yhi mil ra ho ...jysa dosron ka behav wysy hmğŸ¤·â€â™€ï¸	Neutral	0.0
Acha na btao b ab	Neutral	0.0
<A/O> Aby bsdk <A/O> New Zealand Mei India ny test Mei Kia ukharr lia tha last series Mei... 36 all out bhool gye abhi England ny 1st test <A/O> Mei ghr Mei ghuss kr maara hai Tmhai <A/O> ğŸ˜‚ğŸ˜‚ <A/O> South Africa ny 2015 Mei Ghuss kr maara tha t20 series aur ODI 438 runs hahahaha Ghr Mei ghuss kr <A/O> ğŸ˜‚ğŸ¤£ğŸ˜‚ğŸ˜…	Abusive/Offensive	5.0
<A/O> Nkl bsdk ğŸ–ï¸ <A/O>	Abusive/Offensive	4.0
Game May Urien K Ilawa Character Be Hain <A/O> Bsdk <A/O> ğŸ˜‚	Abusive/Offensive	3.0
<A/O> bsdk <A/O> pori bat sun ly	Abusive/Offensive	3.0
Wo <A/O> bsdk <A/O> ka Kon ha .. ğŸ˜ª	Abusive/Offensive	3.0
<A/O> Bsdk ky <A/O> ğŸ˜‚	Abusive/Offensive	3.0
<A/O> Tw e ha bsdk ky <A/O> or kn ha ğŸ˜‚â¤	Abusive/Offensive	3.0
Comments on kar <A/O> bsdk <A/O>	Abusive/Offensive	3.0
aj kitna gnda khaila ğŸ¤ğŸ¤ğŸ¤ğŸ˜ğŸ˜ğŸ˜‘ğŸ˜‘	Neutral	0.0
oh chala ja <A/O> bsdk <A/O>	Abusive/Offensive	3.0
Abay yaar <A/O> yeh bsdk. <A/O>	Abusive/Offensive	3.0
<A/O> Ye bt bsdk <A/O> hata k keh skte the?	Abusive/Offensive	3.0
<A/O> Chall bhaagh BSDK <A/O>	Abusive/Offensive	4.0
Stats hota <A/O> Bsdk <A/O>	Abusive/Offensive	4.0
<A/O> Bsdk <A/O> attack krwa dya nacho kuni	Abusive/Offensive	4.0
<Rel> Tum apni ma se puchna k Tum bsdk ho ya Brahma ki ulti se paida huye hoğŸ˜ƒğŸ˜‚ <Rel>	Religious	5.0
<A/O> To tu hai bsdk to tu azaaab hai har kisi pr <A/O>	Abusive/Offensive	4.0
<A/O> Ye bsdk <A/O> 5 match har kr ak jeet kr shokhy ho jaty hain <A/O> mc <A/O>	Abusive/Offensive	4.0
<A/O> Gand dho kr bat kr nikl bsdk <A/O>	Abusive/Offensive	5.0
<A/O> Bsdk tune 4 saal se monh nahi dohya <A/O> aor skin care routine bataega humain	Abusive/Offensive	4.0
<A/O> Lpc bsdk <A/O>	Abusive/Offensive	4.0
ğŸ‡±ğŸ‡· Hapi birthday dude ğŸ‡µğŸ‡° <A/O> Bsdk <A/O> roti khawa	Abusive/Offensive	3.0
<A/O> Bsdk <A/O> unki class ma 96 larkian and 4 larky including them and they aint lieing j can assure u that	Abusive/Offensive	3.0
Aisa kr majid mai allan kr d	Neutral	0.0
<A/O> Lpc <A/O> mtn sltn	Abusive/Offensive	3.0
<A/O> Lpc gandu <A/O>	Abusive/Offensive	4.0
<A/O> Lpc <A/O>	Abusive/Offensive	3.0
Waise to main aj kal kisi ko msg nahi kerta ker bhi loun to aglay kehte hein <U> LPC <U>	Untargeted	3.0
<A/O> LPC Bhnchod <A/O> sary	Abusive/Offensive	3.0
<A/O> Lpc <A/O> bhai	Abusive/Offensive	3.0
<A/O> Lpc you pendu kachi abadi patwari <A/O>	Abusive/Offensive	5.0
LPC obviously means Liquid Petroleum Cylinder	Neutral	0.0
Mubarak to you too ğŸ˜‡ Salamti ho â¤	Neutral	0.0
"How problematic is this mindset of asking ""ArE yOu sHiA?"" If one post or talk about Ehl E bait E at'haar a lot. O Bhai go get a life and research about Deen first. Ajeeb."	Neutral	0.0
shias feel another type of happiness when their non shia friends congratulate them on Imam Ali's day. thank you to all the non shias who updated their status for our Master AliØ¹.	Neutral	0.0
RT : Being Shia Of ALI [A] is the best blessing of my life.!! â¤	Neutral	0.0
Bruh! shia priest?	Neutral	0.0
Literally no one, But we Shia_E_Ali (as) are continually sending and receiving 13 Rajab's Vibes So Blessed We are Wallah!	Neutral	0.0
Bhai ghareeb hun data end hony wala	Neutral	0.0
Ywr kia chah rhy tm mery sy	Neutral	0.0
Still couldn't figure out why shia girls are thristing over this guy	Neutral	0.0
"Irony is that Zoya's fiancÃ© converted to Islam to marry her, meanwhile our Muslims boises be like ""shia ho? Shaadi kr nahi krskta!!""ğŸ™ƒ"	Neutral	0.0
Shahid Baltistani wali sunno !! Murtaza mill Gaye our kya chahiye ğŸŒ¸ğŸŒ¸	Neutral	0.0
You are such a ignorant person I did not know shia has started calling themselves minority lol...how old are you? it seems someone is giving you money to tweet, <A/O> please ask him money so you can get education? <A/O>	Abusive/Offensive	1.0
Huh pechlay sawalon k jwab aney tk nahe boluga ub wese bhe ğŸ¤§ğŸ¤§	Neutral	0.0
Oh haan Yaad aya ğŸ˜… poochnay per tou wese kuch nai btati aaap ğŸ¤¦ğŸ»â€â™‚ï¸ğŸ¤¦ğŸ»â€â™‚ï¸ Sorry Bhool gaya tha ğŸ’¯	Neutral	0.0
All in All Shia ğŸ˜‚ğŸ˜‚ Jesa des Wesa Bhes ğŸ˜‚ğŸ˜‚ I believe k kisi ko apna Aqeeda na btaya jaye tou jo jo kehta hay os ki haan mein haaan milai jao bs falanay Falany falany ki tareef k illawa sub chalay ga ğŸ˜‚ğŸ˜‚ğŸ˜‚	Neutral	0.0
I hope I ran remain consistent for #Shia Majority Kashmir	Neutral	0.0
<A/O> Chotiyu ko bhi chotiyapa lagta hai <A/O> hairat huiğŸ§ğŸ§	Abusive/Offensive	4.0
#bigg boss <A/O> chotiyapa <A/O>	Abusive/Offensive	3.0
Is thran se famous hone ko <U> chotiyapa <U> kahte hain ache image ke sath famous hona nahi bruh:)	Untargeted	3.0
Very disappointed by this act javed should call the other girll not this <U> chotiyapa <U>	Untargeted	3.0
<U> kia chotiyapa tha yah <U> .. opening ceremony kay naam par .. khan sahab ko kab nazar aye ga yah sab ....	Untargeted	3.0
kya psL psL lgai ha <U> band kro ye chotiyapağŸ˜ª <U>	Untargeted	3.0
Ya kya paresaan rahenge ya <A/O> khud he chotiyapa kar k baitha hai <A/O>	Abusive/Offensive	3.0
<A/O> Bharwe dafa ho <A/O> tujhe account deya hai toh shoka mat ho	Abusive/Offensive	4.0
Musharaf ki agar Masjid se koi dushmani thi to us ne Faisal Masjid, Badshahi Masjid ya Karachi ki Memon Masjid per Aisa hamla kyon Nahi Kiya? <A/O> Burkhe wale bharwe per lanat. <A/O>	Abusive/Offensive	4.0
<A/O> Bharwe <A/O> tune app khol k check ki? Abhi tk full of bugs h and 0 score and sabki koi mails public ğŸ‘ŒğŸ‘ŒğŸ‘Œ	Abusive/Offensive	3.0
<U> Kis bharwe <U> ne bola bhai, bol abhi pelte hai sale ko	Untargeted	3.0
but it is india vs pakistan, its biryani vs karahi, yaarr vs abey, mobile nikaal <U> bharwe vs tu bara penchod hai, <U> safai vs kachra, altaf bhai vs sharif khandaan, ppp vs pti	Untargeted	4.0
<A/O> Jbh bharwe tum gandu ho boht baray <A/O>	Abusive/Offensive	4.0
Nani hypocrisy ki bhi koi sima hoti hai <A/O> Chor ki beti chor on inko support karne wale lifafe sahafi nhi dalal or bharwe hain <A/O> Pakistani people stand with PMIK ğŸ‡µğŸ‡°ğŸ‡§ğŸ‡«	Abusive/Offensive	5.0
<A/O> Bc <A/O> kaisay banate ho ye snaps <A/O> bharwe salle <A/O>	Abusive/Offensive	4.0
RT : <A/O> Arre mc bharwe <A/O> kitna juth failayega <A/O> bsdk <A/O> ğŸ˜ 	Abusive/Offensive	5.0
Kachori khatam ho gyi kia <A/O> bharwe <A/O>	Abusive/Offensive	3.0
Tmhare dene na dene se mandir ka banana ruk jayega? <A/O> Bharwe <A/O>	Abusive/Offensive	3.0
soja <A/O> bharwe <A/O>	Abusive/Offensive	3.0
Shokha na ho <A/O> bharwe <A/O> harjayenge hum	Abusive/Offensive	3.0
<A/O> Bharwe <A/O> izzat hai lekin tujhe samjh nahi ayegi	Abusive/Offensive	3.0
Saat ma kuch or bhi dekh na <A/O> bharwe <A/O>	Abusive/Offensive	3.0
Ja nah <A/O> bharwe <A/O> kam kar apna	Abusive/Offensive	3.0
Aye ja nah <A/O> bharwe <A/O> chaba mat	Abusive/Offensive	3.0
r u talking abt me <A/O> bharwe? <A/O>	Abusive/Offensive	3.0
Date krne ki nahi <A/O> bharwe <A/O> 5 sal se they ğŸ˜’ğŸ˜’	Abusive/Offensive	3.0
<A/O> is bharwe <A/O> ko lelo koi VOUCH for drift daddy	Abusive/Offensive	3.0
Hassan Ali <A/O> ffs bc <A/O> kyaa celebrate kar raha hai? <A/O> sharam aani chahiye bharwe <A/O>	Abusive/Offensive	4.0
<A/O> Abey chutiye <A/O> ye to ghaddar ha govt against party ka ha <A/O> is bharwe <A/O> ki yaha nahi sunta koi tu humko suna raha ha, <A/O> gandu <A/O> apne congress party ki bhi sunle pehleğŸ¤£	Abusive/Offensive	5.0
hahahahahahhaha mcdonalds de mujhe <A/O> bharwe <A/O>	Abusive/Offensive	3.0
Udr hi jarha na <A/O> bharwe <A/O> raste me hu	Abusive/Offensive	3.0
helpp why this <A/O> bharwe?? <A/O>	Abusive/Offensive	3.0
astagfirullah meri abba mohutarma se tameez se baat kar warna <A/O> uthwa lunga bharwe <A/O>	Abusive/Offensive	4.0
han <A/O> bharwe <A/O> nuggets nikal	Abusive/Offensive	4.0
<A/O> wo aik number ka chotia banda hai pervez rasheed us bharwe ko tameez nae hai <A/O> <A/O> jahil hai wo porana baba hai wo <A/O>	Abusive/Offensive	5.0
<A/O> Bazid Bharwe <A/O> ko sakoon nhi hai kya!!	Abusive/Offensive	3.0
Like kr <A/O> bharwe <A/O>	Abusive/Offensive	3.0
<A/O> Bharwe kahin k <A/O>	Abusive/Offensive	3.0
Haan <A/O> bharwe teri baji ko choda hai. <A/O>	Abusive/Offensive	4.0
<A/O> bharwe <A/O> tu nazar hi nahi ataa ab	Abusive/Offensive	3.0
<A/O> Tum gai kyun tatte uthane? <A/O> <A/O> Bharwe or dalal ho sahafi nhi tum <A/O>	Abusive/Offensive	5.0
<Rel> to marja bharwe tere liye konsa halal haram ka masla hai <Rel>	Religious	5.0
<Rel> Chutiye apni tatti ğŸ’©ğŸ’© wali shakal change kar <Rel> or han Sid ke khilaf mat bol <Rel> apne idol ki chaat ache sey bharwe Nalle <Rel> ğŸ˜¡	Abusive/Offensive	5.0
<Rel> O bharwe.. <Rel> Lahorion ki urdu esi hoti hai... Mtlb kuch bhi...	Abusive/Offensive	3.0
<A/O> Or bharwe <A/O> agr aisa hota to <A/O> Tmhara Kutta Abhinandan <A/O> na de dety thme, <Rel> Tum hindu harami hoti hi namakharam ho <Rel>	Religious	5.0
<A/O> Bharwe <A/O> fantasy Ka bta <A/O> Kia Randi Pana krdia h tune <A/O>	Abusive/Offensive	4.0
<A/O> tu ikku bharwe <A/O> kisi aur zubaan me gaali deta hai	Abusive/Offensive	3.0
tumhare lie ez hai <A/O> bharwe <A/O>	Abusive/Offensive	3.0
<A/O> Bharwe <A/O> itna target de kr bhi har rahe	Abusive/Offensive	3.0
<A/O> Is bharwe <A/O> ko bolna merko tag karke report ka bole taaki thoda engagement mile merko ğŸ˜­ğŸ˜‘	Abusive/Offensive	3.0
<A/O> tumhari ma itni sasti randi hai koi free mai bhi na chode bharwe ke bacho <A/O>	Abusive/Offensive	5.0
ro nai <A/O> bharwe <A/O> agaye aur events aynge chill	Abusive/Offensive	3.0
Okay kill me on monday ,rn sojao <A/O> bharwe <A/O>	Abusive/Offensive	3.0
<A/O> Lynn bharwe <A/O> se paisay wapis le lo	Abusive/Offensive	3.0
<A/O> Hafeez bharwe <A/O>	Abusive/Offensive	3.0
Sardian hai <A/O> bharwe <A/O>	Abusive/Offensive	3.0
<A/O> Bharwe <A/O> baatein kisko krrha hai <A/O> gandu <A/O>	Abusive/Offensive	4.0
<A/O> Tere ma ki bahanchod <A/O>	Abusive/Offensive	5.0
<A/O> Bahanchod <A/O> me obc se hu or mujhe koi problm nhi h kisi se bina marzi obc ka name kyo Leta h next time FIR krwa duga	Abusive/Offensive	3.0
<Rel> bahanchod tu peda hi...lagta hy hallalla se hua hy..... <Rel>	Religious	3.0
<A/O> Bahanchod <A/O> fake news failata hai edit kiya hua	Abusive/Offensive	3.0
Acha hua <U> bahanchod <U>	Untargeted	3.0
A jcb wala kon hai <A/O> bhosriwalo iska no. De bahanchod ka <A/O>	Abusive/Offensive	5.0
Uncle 3 shadiyan kar k yeh b aqal ni i k beti ki age ki larki ko lanat da rhe do <A/O> bary bahanchod ho phr toh uncle g <A/O>	Abusive/Offensive	3.0
<A/O> Bahanchod fuck jio network. <A/O>	Abusive/Offensive	4.0
Achha to itna batado ki <A/O> kis madharchod bahanchod <A/O> ne pulwama attack karwaya aur kyu karaya	Abusive/Offensive	4.0
This is called feminism <Rel> # Halala.#bahanchod katue <Rel>	Religious	4.0
Mera dance se man utha diyaa <U> bahanchod tune. <U>	Untargeted	3.0
<A/O> Bahanchod <A/O> har Baar wo game kyu yaad dilana hai sabko <A/O> mc <A/O>	Abusive/Offensive	4.0
<A/O> oyee gandu <A/O> <A/O> sar fod du tera bahanchod <A/O>	Abusive/Offensive	5.0
tujhe 10k pe kisne pocha diya <A/O> bahanchod!!! <A/O>	Abusive/Offensive	3.0
<A/O> Bahanchod <A/O> darmay kartay hai <A/O> bagrat ya <A/O>	Abusive/Offensive	3.0
Not affordable ğŸ˜‚ğŸ˜‚ğŸ˜‚ <A/O> Bhosdike <A/O> wo private company he..wo apna saman kitane me bhi bech sakta he.. <A/O> bahanchod <A/O> usne theka liya he kya affordable banane kağŸ¤£ ase to trend karega Protein powder affordable nahi heğŸ¤£	Abusive/Offensive	4.0
<A/O> Madarchod mara Tum bahanchod wala <A/O>	Abusive/Offensive	4.0
<A/O> Bahanchod <A/O> reservation milta hai free ka khana milta hai free ka makan milta hai <A/O> fr bhi gaand garai hai tum logo ki mehnat karke kamate to chutiya panti na karte <A/O>	Abusive/Offensive	4.0
<A/O> Tery jaishy kutiye chood trey jasho sy bahas karana bykar bahanchod <A/O> <A/O> sirf twitar ka kutaa hai madharchod. <A/O>	Abusive/Offensive	5.0
Kuch aur sun liya kr <A/O> bahanchod <A/O>	Abusive/Offensive	3.0
<A/O> Sala bahanchod <A/O>	Abusive/Offensive	3.0
ARE NAHIN CHAHIYE CREDIT CARD OR HOME LOAN <A/O> BAHANCHOD !! <A/O> 21 number block kar chuki hoon is hafte .	Abusive/Offensive	3.0
<A/O> Bhak bahanchod <A/O> ğŸ¤£ğŸ¤£ğŸ¤£ğŸ¤£ğŸ¤£ğŸ¤¢ğŸ¤¢ğŸ¤¢ğŸ¤¢	Abusive/Offensive	3.0
<U> Bahanchod <U> samajh nahi aa rha hai <U> itni buri tarah se phati padi hui hai <U> lekin padhai phir bhi nahi ho rhi hai	Untargeted	4.0
Amma abba se door ho kar karna warna log kahe ge kisi ne kaalay jadu se kaala muh kar diyağŸ˜‚ğŸ˜‚ğŸ™Š	Neutral	0.0
Main to kaala hun ğŸ¥ºğŸ˜‚	Neutral	0.0
Its already blacklisted. Aur kitna Muh kaala Karvaoge pakistan #BlacklistPakistan again for #Pawri	Neutral	0.0
<S> Ro Ghasti ro <S>	Sexist	3.0
<Rel> jin haramion ne mujhe kharab kiya hai unhi ke ringtone pe karam maangta hun ata mangta hun naat lagi hai <Rel> ğŸ‘ğŸ‘ğŸ‘ğŸ‘	Religious	2.0
hi <A/O> gandoo <A/O>	Abusive/Offensive	3.0
Kr ly <A/O> gandoo <A/O>	Abusive/Offensive	3.0
<S> uzma tum ik gashti orat ho <S>	Sexist	3.0
Or <S> tum pakistan ki certified gashti gu <S>	Sexist	3.0
<A/O> Tmhari maa gashti <A/O>	Abusive/Offensive	3.0
<U> jisney match ki koi tweet ki uski maa gashti <U>	Untargeted	3.0
<A/O> gashti ky bachy <A/O> tu apna kam kr baqion ki chior <A/O> kisi kutti ky bachy. <A/O> Tum log humaray tax ky pyson sy perh kr yahan pohonchy ho <A/O> kisi urti gashti ki olad. <A/O>	Abusive/Offensive	5.0
<A/O> Kisi gashti ka bacha hai ye <A/O>	Abusive/Offensive	3.0
<S> Gashti <S> aap ka misal wo digar wali . Ky amgoor khatty hain	Sexist	3.0
<S> Gashti Randi sali <S>	Sexist	4.0
<S> Lanat is gashti te <S>	Sexist	4.0
<A/O> Tmhra qasor ni tum hu e gandi nali k pedawar q tm clear hramzda hu <A/O> <A/O> beghrt gashti k <A/O>	Abusive/Offensive	5.0
<S> is gashti <S> ka ego dekhoo abhi follow kiyya	Sexist	3.0
<S> Ghar se bhaag jaany wali gashti <S>	Sexist	4.0
Aap ko pata to <S> bohat bri gashti <S> tention na le <S> imran khan teri phuddi nhi le ga gashti bachi behnchood <S>	Sexist	5.0
<S> gashti <S>	Sexist	3.0
<A/O> To apni choti baaji ka rishta na de kisi gashti ki aulaad <A/O> <A/O> teri maa gashti he tujhy pata he wo chakla chalati behnchod gaando <A/O>	Abusive/Offensive	5.0
<S> Teri behn ko chodo gashti ki bachi <S> <Rel> to he haram ki aulaad najaiz aulaad <Rel> <S> gashti teri maa gashti tera baap dalla tha tera pura gar kanjar khana tha <S>	Sexist	5.0
Tum ko fouj itni buri lagti he to <S> phuddi de do fouj ko behnchod gashti <S>	Sexist	4.0
<A/O> Teri anmi aur baaji ki yaar he fouj kisi gashti maa k bachy <A/O>	Abusive/Offensive	5.0
<A/O> Kisi sasti gashti k bachay <A/O> Pakistan fauj larna na jaanti tou teray katooray Abhinandan ko jo pakar k danda diya is oh saari dunya be dekha. civilian matters main interference fauj ki buhat bari ghalati hai laikin hum India ka narrative phailaayein, <A/O> LANAT ghadaar maa k bachay <A/O>	Abusive/Offensive	5.0
<A/O> Hum Tu pehlay hi kehtay thay yeh Kisi gashti k bachay Hain <A/O> now proved ğŸ˜…	Abusive/Offensive	4.0
<S> Sali gashti tujhe pichli chudai Yaad nhi kya <S> ğŸ˜‰ <S> Kapde faad k nangi kar k mooh mein loda thus thus k Teri chut mein jhatke maar maar k Khun nikal Diya tha na <S> ğŸ˜‰ Phir Uske baad naye dress diye na ğŸ˜‹ Yeh wala bhul gayi?	Sexist	5.0
<A/O> Teri maan Gashti <A/O> .........ğŸ˜ğŸ˜†ğŸ˜‹	Abusive/Offensive	3.0
<U> Kisi Gashti Ke Bachey Ne Kiya Hai server Nuked <U>	Untargeted	3.0
Tm ghareloo NhI ho na <S> Tm tu pti ki gashti ho <S>	Sexist	3.0
Or <S> tm gashti ho <S>	Sexist	3.0
Yah ak alm e Deen ke zaban ha? Chalo Asa ha to phir asa he sahee <A/O> Amir to kasi gashti kah bacha ha taree nae Wali bv ko kuta choden <A/O>	Abusive/Offensive	5.0
<A/O> Kissay gandi gashti k bachay patwari. <A/O>	Abusive/Offensive	5.0
<A/O> Bawa Ji ki maaa chud gaiii <A/O> ... original clip main aisa kuch nahi jesi tuhmatay ye laga raha tha <A/O> gashti ka Bacha <A/O>	Abusive/Offensive	5.0
<S> Shakel se he gashti lagti ha maderchood <S>	Sexist	5.0
G <S> gashti tmhin shayad andaza ni ha k imran khan Teri trha kitna ghtya insan ha ye zra intelligence k logo se apni ek dafa marwa k puch lo. <S> <S> Is begairat ne sirf ek Kam Kia ha k Teri jesi gashtyun ko Kam dalwany ki khuli chhuti di ha <S>	Sexist	5.0
<A/O> Gashti ke bachay <A/O> Simon doull ki baat kr rha he <A/O> gand phti ge Kisi ruli rndi ke bachay <A/O>	Abusive/Offensive	5.0
<Rel> Haram Khorrr gashti <Rel>	Religious	4.0
Teray muhallay walay bhi sahi kehtay hain that you can't give results that's why your neibhourhood has to interfere. <A/O> Go for your kids DNA gashti ki olad <A/O>	Abusive/Offensive	5.0
<A/O> Tm jesy gashti k bachon <A/O> ki wja se hi to jahalat khtm nhi ho rhi aur baakion ko b yh <A/O> syasi log chutiya smjhty hain. <A/O> <A/O> Patwari waqae dagarh dally hoty hain <A/O>	Abusive/Offensive	5.0
<A/O> Kisi Aaalaw kism k gashti ka bacahy <A/O> tujh say to teri bivi teri maa tery behn bhai rabty main nahi hongy jhooty shaks	Abusive/Offensive	4.0
<A/O> O kutty insan <A/O> tn hota kn ha mare fojj py <A/O> bhokny walay o zaleel insano <A/O> tm jeson ko ur <A/O> tmhari iss kutti gashti leader ko main apni fojj k boot py war dn <A/O>	Abusive/Offensive	5.0
<S> Es Gashti Khusri K Moo'n Par Thukna Chahiye tha <S>	Sexist	5.0
<S> Gashti <S> run	Sexist	3.0
Abey tumhare mute se mujhe farak nhi prta <S> gashti, <S> acha hai ek bawaseer chale jayga	Sexist	3.0
<S> Gashti ki aur gando ki olaad iss ny yeh bakwas kab ki <S> , <A/O> laanat pehly iss par aur baad main tum par <A/O>	Sexist	4.0
<S> gashti-vity <S>	Sexist	3.0
<Rel> Haram kee tukham teray baap zardari kee gashti hai <Rel> woh isliay bura lag raha, PTI walon k saath bura ho tou <A/O> Apni maa k bhosray mein war jatay ho. <A/O>	Religious	5.0
<A/O> Kisi gashti maa k bachy <A/O>	Abusive/Offensive	3.0
Kahan gayab <S> gashti <S>	Sexist	3.0
kia kisi nay <S> Maryam Gashti <S> ka koi tweet India or abhi nandan kay helaf dekha hoto mujy tag krna	Sexist	3.0
<S> Peeli GASHTI <S> ...ğŸ˜ğŸ˜ğŸ˜	Sexist	3.0
ye to lagta ha sari batain <Rel> nawaz kheenzeer <Rel> k khelaf kar raha ha show baaz wesy sahi he bol raha ha <Rel> dalli ka bacha harami nasal k khud to randi bao g nas gaya or ye gashti yahan choor gaya bhoonkny k lia <Rel> or hum baap beta jailo mein	Religious	5.0
Rent a YEH LLOW <S> Gashti <S> ....	Sexist	3.0
<S> Gashti <S>	Sexist	3.0
RT : First one is a super star. The other is a <S> Gashti. <S>	Sexist	3.0
Apki b hai videos mere pass <S> gashti <S>	Sexist	3.0
<A/O> Teri pain nu Gernal bajwa da lun salya gashti dya bachya <A/O> <A/O> bakwas band kr apni <A/O>	Abusive/Offensive	5.0
<S> GashtiğŸ˜³ <S>	Sexist	3.0
<S> Lanat ho tum pe memona gashti <S>	Sexist	4.0
<A/O> Gashti k bachy <A/O> tu Mary trf tha na ğŸ˜­ğŸ˜­ğŸ˜‚ğŸ˜‚ğŸ˜‚ğŸ˜‚	Abusive/Offensive	3.0
<S> Lahor ki Gashti Heera Mandi Ki Kanjri Maryam safdar <S> <A/O> Foj pa Bonkne wali Kottiy <A/O> a ko Giraftar Kiya jay Or Lahor Haai kot Band hona chaiye ğŸ‘¢	Sexist	5.0
<S> gashti <S> kahan ho?	Sexist	3.0
<A/O> Teri Ma KO chodun Gashti Teri Ma Randi Ki Bachi <A/O> Bsdkk	Abusive/Offensive	5.0
RT : <S> Teri gand ma jo kharish ho rahi hai wo hum door kr dety hain naizi k l pr na charo gashti <S>	Sexist	3.0
<A/O> Gashti k bachay <A/O> ignore krr detay hain jese main fan him inka <A/O> maderchod k bachay <A/O>	Abusive/Offensive	5.0
Han me yahan likh deta hu k teri baaji gashti hai, whole world should believe it, right!? <A/O>	Abusive/Offensive	4.0
<A/O> Yeh lanat apni gashti maa py bhej jis ny tere jesa kuta paida kia <A/O>	Abusive/Offensive	4.0
<A/O> Gashti k bachay <A/O> khila q nai rahay	Abusive/Offensive	3.0
nahi wysy aj bara hi taqleef deh din hy kyun keh 27 feb jo hyjis din tumharay pilot ko chai pilai thi. <A/O> Thukai kerny ky badd gashti ki olad. <A/O>	Abusive/Offensive	4.0
<S> Genuine question: Who invented word Randi? The net tells me it came into being post 1966 then reham khan came in world gashti <S>	Sexist	5.0
Nope <A/O> Nawaz Sharif and his two sons gashti y bachy. <A/O>	Abusive/Offensive	3.0
Main koi SM member nahi hu PTI ka <Rel> harami indian randi ki olad. <Rel> Niqal yahan sy or <Rel> ja kr apni gao mata ka pichwara chat. <Rel> <A/O> Niqal yahan sy gashti ki olad. <A/O>	Religious	5.0
buhahaha. daleel. <A/O> Gashti ky bachy <A/O> konsi daleel di hy tu ny. Spot rates on average musalsal neechy rahay pichly 3 saal long term contract sy or <Rel> bakwas kerwa lo Indians harami on sy <Rel> Nawaz ki mohabat main.	Religious	4.0
fps boost kar mere <S> gashti <S>	Sexist	3.0
Italy Mai <S> matar gashti <S>	Sexist	3.0
Baat tau saheeh hai. Lekin shaid iss bahanay lifafa hee mil jaye	Neutral	0.0
RT : <A/O> Shame on Hamid Mir! Shame on Asma Sherazi! Shame on #Lifafa gang! <A/O> #ShahabLeaks #ArrestHamidMir #AsmaSherazi	Abusive/Offensive	3.0
"<A/O> Ye ""Lifafa"" Launda <A/O> Jhoot bol raha ha. #ShahabLeaks seb fraud ha. Main gawahi deta hoon, Hamid Mir kaii Saal pehly keh chuka ha k mera Facebook pay koi account nhi. Main wo jaali accounts dekh ker ignore kr diya krtaa thaa. Ab ye Asma Shirazi k baary mn <A/O> bekwaas kr raha ha. <A/O>"	Abusive/Offensive	3.0
What type of sycophants we have in our society... shameless characters.. <U> lifafa journalist.. <U>	Untargeted	3.0
<A/O> HAMID MIR sirf lifafa chahta hai. <A/O>	Abusive/Offensive	3.0
Hahahaha.... immature attempt to prove Hamid Mir as...... innocent....hats off you <A/O> ...Mr lifafa journalist... <A/O>	Abusive/Offensive	3.0
<A/O> In Pakistan we call them Lifafa and it means those who take money from their masters to bark in the direction their masters want, ao u should not try to portray him as a savior. <A/O> His colleague <A/O> Asad toor has been a foul mouthed YouTuber and bot a real journalist and a drug paddler <A/O>	Abusive/Offensive	5.0
Asal my hmy lifafa journalism ki adat ho gae is leiy haqeqat haqeqat ni lagti... #ShahabLeaks	Neutral	0.0
Bhai t apne bete ko khilalo t20.... <A/O> Lifafa journalist... <A/O>	Abusive/Offensive	3.0
<A/O> Mir Mohammad ali niazi kuttay ka lifafa ha khud ki 2 takay ki aukat nai <A/O> hamid mir say <A/O> bakchodian kar raha ha pti ka dalla <A/O>	Abusive/Offensive	5.0
Lifafa chaye?	Neutral	0.0
Apki achi naukri hai farzi doctor, har positive post pe ja k yahi 1 tweet kerte raho aur phir <A/O> PMLN media cell se har month lifafa ata rahega. <A/O>	Abusive/Offensive	3.0
Jab tak IK ki hakomat nai ai thi. Dunya ko nai pata tha k yahan bikay huway Lifafa journalist main stream media May anchors Aur analyst ban k atay hy. Aur barmla kehtay hy k hm to Hakomatayn banatay aur giratay hy. Ap sab buri tarha expose ho kar reh gaye	Neutral	0.0
Salam apko aur han main lifafa nee hun!	Neutral	0.0
The same idiot who slap poor on duty police constable for doing his duty, these people can give you lifafa and you can bidding for him all you can but they are corrupt and part of mafia!	Neutral	0.0
<A/O> Hamid Mir is a swindler n a fraudia 3rd class lifafa journalist <A/O> so pl don't compare him with yourself...	Abusive/Offensive	4.0
Dispretly waiting for another lifafa leaks.	Neutral	0.0
<A/O> Tum Shuru se lafada ho the is Hukumat Ne Tumhen Lifafa Diya <A/O> jisse Tum Apna Ghar Shuru kar liya Garib aadami ko kya Mila Hai batao pahle Tumne Do sadiyan Ki Hain <A/O> lifafe <A/O> Tujhe Milte Hain <A/O> badtamiz Insan Ho Tum <A/O>	Abusive/Offensive	4.0
Why TF is an <Rel> Indian piss drinking moron <Rel> talking shit here? Further proof that Indian agencies are behind <A/O> lifafa brigade. <A/O>	Religious	4.0
Chal <A/O> Lifafa journalist <A/O>	Abusive/Offensive	3.0
<A/O> Lifafa bol Raha ha <A/O>	Abusive/Offensive	3.0
<A/O> Buhut Barra lifafa hay bhai <A/O>	Abusive/Offensive	3.0
<A/O> Wo b tery jaisy luchy hain <A/O> <Rel> ...chitter pary hoye hain unko ....tery sath sirf or sirf lifafa or hram khoor khara hy <Rel> ..baki koi nai	Religious	4.0
<A/O> aur ap khud lifafa ly k beth gayi, ap jesy logon ny sahafat badnaam kr di <A/O> ab koi sahafi nazar aye to khayal ata k <A/O> mir ki tarah ghaddar n asma ki tarah lifafa hoga bs <A/O> ğŸ–ğŸ» lanat aisy sahafiyon py	Abusive/Offensive	5.0
Waise tum mujra dekhti ho kya hiramandi k bazar me roz aise dance hote hai na ek video bheja hai Afghan bhai ne dekhna chahoge ğŸ¤—ğŸ¤£	Neutral	0.0
<A/O> Hiramandi di aullade hengi sali <A/O> .... <A/O> maa di lun penchoda di <A/O> ..... <A/O> lakh di lanat innha vargi mava de jinhaa ne inni gandi aullad jammi <A/O>	Abusive/Offensive	5.0
<S> tumhari aur tumhari ammi ki hiramandi se 1billion dollars earnings hon gi sabse chudwatey ho maderchood <S>	Sexist	5.0
<S> Veena malik meera ya sunny Leone kyunke gshti ki history pe gshti hi jchaygi <S>	Sexist	3.0
<S> ap bhi gshti aur bhi gshti <S>	Sexist	3.0
<S> Is gshti ki soch pe lanat kese khud k jism ki publicity kr rhi hai <S>	Sexist	4.0
<S> o gshti bqwas bnd rkh <S>	Sexist	4.0
<S> Gshti orat <S>	Sexist	3.0
<A/O> Nahi g iss ki maa heera mndi ki sb se bri gshti <A/O> this to smj jayne <Rel> Putr kitna bra hrami ho ga <Rel>	Religious	4.0
<Rel> Yeh gshti ka bcha AEO hai udr hrami nsl ka <Rel>	Religious	4.0
<S> wha gshti wha <S>	Sexist	3.0
<S> Gshti dio bachio lantio <S>	Sexist	3.0
Buhahahah. Kaya hua jawab nahi a raha hy keh 13.37% wali deal mehngi par gai hy. <A/O> Lekin Indian gashti ky bachon <A/O> ko Nawaz pasand hy jysy humain Modi pasand hy. <A/O> Niqal yahan sy gashti ky bachy. <A/O>	Abusive/Offensive	4.0
or is ky baad kaya hua tha woh bhi parh ly. Wohi supply kam price main mil gai thi. Magar kaya kia jy <A/O> Indian gashti ki oladon ko phir bhi bakwas kerni hoti hy. <A/O>	Abusive/Offensive	4.0
Phir kaya bolayn tum ko <S> chikney choudo gashti <S> jo tum ko acchi lagay wo bolo ga tum ko.	Sexist	4.0
<A/O> Gashti k bachy endian <A/O>	Abusive/Offensive	3.0
Tm chalti sb phly Maa behan dono chalti ho <A/O> gashti k bachi <A/O>	Abusive/Offensive	3.0
buhahahah. <A/O> Aa gaya bhosri ka maa chudanay. <A/O> <A/O> gashti ky bachy <A/O> tu toh keh raha tha keh zaiada price pr khareedi us ka jawab dy na jo main ny kaha hy kisi urti <A/O> khassi maa ki olad. <A/O>	Abusive/Offensive	5.0
RT : ahhh how do i get my reach back <A/O> twitter gashti ka bacha na ho tou <A/O>	Abusive/Offensive	3.0
<S> is gashti <S> ko foregin affair pe bolny ka kis nay kaha ? or <S> ye randi <S> har urta howa teer edhar q lay ati hain. kia itni kamzor ha k kuch action nai ?	Sexist	4.0
RT : reject a brown and they will be like oh woh <U> toh wese bhi gashti thi <U> ..lol	Untargeted	3.0
Agar mera miscarriage ho gaya hota tu <A/O> teri gashti maan <A/O> ka aik customer kam ho jata aur <A/O> woh tujhe jaise dallay ko paal poos ke bara na ker sakti. <A/O> ğŸ˜‚	Abusive/Offensive	5.0
<S> Gashti aurat <S> ...	Sexist	3.0
<S> Gashti <S>	Sexist	3.0
<S> Sali gashti zamny ki <S>	Sexist	4.0
Haha why u want to meet me lol talk to <S> mere saali sasti gashti land chaiye mere ? <S>	Sexist	4.0
Shakal tou meri khuda nay bani hay <A/O> tou nay apni behan ka rishta ni dena tou na day kisi sasti gashti kay bacha randi ki olad <A/O>	Abusive/Offensive	5.0
<S> Gali Gali me shor ha Mariam Gashti Chor ha <S>	Sexist	5.0
Q k teri maa ka khasam he Ahsin iqbal. <A/O> Gashti k bachy <A/O>	Abusive/Offensive	3.0
Lekin <A/O> GASHti ka bach-ha <A/O> us kay khilaf appeal dair ker raha hai ...	Abusive/Offensive	3.0
<A/O> Aik kutta salman khalid <A/O> bhi rakha jo <A/O> apniii maaa paish karnay a gaya ha <A/O> ... <A/O> gashti ka bacha <A/O>	Abusive/Offensive	5.0
<Rel> jo tumhari maa chod k bheji wapis usko bhol gyi ho gashti maa k bchi randi bhenchod WEHSHEYA haraam zaadi saaali kuttiya ki bchi BITCH. <Rel> <S> YOU'RE A CHEAP MOTHER FUCKING SLEAZY PUSSY which is brutally fucked where ever its found. <S> <S> ana fir khusbu lga k phaar k ulti ltka denge CHOOT OK <S>	Sexist	5.0
<S> Gashti politics d <S>	Sexist	3.0
<S> Gashti ka analysis <S>	Sexist	3.0
<S> Tu Gashti Meray L Ka Mukabala Kary Gai Bc Dangar <S>	Sexist	5.0
<S> Certified Gashti <S>	Sexist	3.0
<S> Gashti <S>	Sexist	3.0
Hahahaha hahahahaha <S> jb es ki gand phatti hai mujy boht maza aata hai sali gashti siyasi randi tum kro to fun hum kren to chudai randi ki bachi <S>	Sexist	5.0
Tera e wait kr rha tha k <A/O> tu bhonky edr be a kay,, <A/O> amma hai tu uski..? Apny kam sy kam rakh aur <S> dubara maa chudwanay mat ana,,,bc gashti <S>	Sexist	4.0
RT : <A/O> In se koi poucho bhai tumhaari amma ki doosri suhagraat hai aj jo baajy baja rahy ho gashti k bacho <A/O>	Abusive/Offensive	5.0
<Rel> or teri peen ko to full LUL varr jae ga ha gashti k harmi bachy chootiyay maryam k bharway nawaz k tattay <Rel> noon leg ki dallali karny k <Rel> 2 tokray khanay wala harami dalla <Rel> <A/O> tujh sy gali ka kutta hazaro darjay behtar ha <A/O>	Religious	5.0
<Rel> Lan par charh Haram zaday kuttay kay bachay gashti ma ka bacha <Rel> tu Kon hay kehnay wala kay na musulman kay liyay hay yeh virus	Religious	5.0
<S> Gashti <S> black list ma dala kis ne ha mulk ko	Sexist	3.0
<S> Sunnn by gashti <S> tiri itni age nhi jitni miry Twitter suspended ho gai 39 account izat ras nhi ati ab thik ho gya <A/O> mother fucker <A/O> have a nice day xxx,,,,,ğŸ¤£ğŸ¤£ğŸ¤£ğŸ¤£ğŸ¤£ğŸ¤£	Sexist	4.0
<S> Eng-land ki gashti taxi (reham khan) <S> ka option nahi daala.	Sexist	3.0
<S> Gashti ki bachi <S> tu choron ki dalal ab <A/O> bhonkay gi <A/O>	Sexist	4.0
<S> Yar wo sach mein gashti thi. <S> Jbh ğŸ˜¶	Sexist	3.0
<S> Ma Chuda gandi gashti <S>	Sexist	4.0
Or <S> tum Pakistan ki phli certified Gashti <S>	Sexist	3.0
<S> Stamp to tary baap ki gand pa lagi ha gashti <S> apne bary ma kia kayal ha <S> gashti number one <S>	Sexist	4.0
Bas kar dadi amaan ban gai hai <S> gashti <S> ab bas kar	Sexist	3.0
<A/O> Gandoo ka puttar <A/O> <A/O> Gashti maa ka bachaa <A/O> <A/O> Behan ka pimp <A/O>	Abusive/Offensive	5.0
<S> Kisi ani gashti ki bachi tere harami baap <S> ne tou re election tou dor halqe kholne se he inkar kia tha. per tou hay <S> loharan di khoti .. tere ooper qatri charhte rahe hain.. teri us tarah li. giy hay jaise kuti ki kuta leta hy tu ne baoo baoo he krna hay <S>	Sexist	5.0
Is ka b k6 bta do <S> ya gashti ho ? <S>	Sexist	3.0
<S> Imran khan ka lan choso phir gashti <S>	Sexist	5.0
Chup ker <A/O> chorni panchod <A/O> , <S> tum sab se Bari certified gashti ho <S>	Sexist	5.0
<S> Lora na choos <S> imran khan ny pehly he bol dia tha <S> tery thoku shobaz ki b mary ga gashti <S>	Sexist	5.0
<S> Tu gashti <S> dlwa k kon gya tha <A/O> kisi gashti ma ki bachi <A/O>	Sexist	4.0
<A/O> Tu zaroor kisi gashti ka bacha hai <A/O>	Abusive/Offensive	4.0
or next 100 saal k liay lag gy ta k <A/O> ye raandi chakla gashti <A/O> jaamhoriyaat say jaan chotay. is mulk mein taraki sarif fouji door mein aai is mulk mein daams sary fouji dor k banay rabdi jaamhoriyaat nay sarif humain nuqsan he dia aakhri player ha	Abusive/Offensive	4.0
Honestly <S> what a sasti gashti <S>	Sexist	3.0
Neem ka pata karwa, <S> raizna gashti sab sey bara bharwa <S>	Sexist	4.0
RT : or us <A/O> gashti k bachy ki maa ko l <A/O> jis ki waja se tu ne tweet del kia wish wala	Abusive/Offensive	4.0
<S> Gashti <S>	Sexist	3.0
<S> Sarkari gashti <S>	Sexist	3.0
Aur <S> tum gashti <S> kya kar rahi ho tum ny konsa baap ka naam roshan kiya hy <S> aik no ke taxi <S>	Sexist	4.0
<Rel> Is Haramzadi Gashti aurat ko main jutay lagaon or Ginti Bhule jaon ğŸ‘ <Rel>	Religious	5.0
<S> Wou tou gashti bhi hey <S>	Sexist	3.0
or us gashti k bachy ki maa ko l <A/O> jis ki waja se tu ne tweet del kia wish wala	Abusive/Offensive	4.0
<S> Put ur raal on ur phodi and rub it gashti <S>	Sexist	4.0
<S> Gashti reham <S> ki dance is top of the list...	Sexist	3.0
<S> Chup oye gashti <S>	Sexist	3.0
<S> jaa oyeee gashti k pilly manhoosy <S> , <A/O> total laanat teri aan waliyaan naslaan te <A/O>	Sexist	5.0
<A/O> Gashti k bachon <A/O>	Abusive/Offensive	3.0
Dr bewkoof hai. Jo <S> tery jiasy gashti <S> ki tweet py comment kr raha.	Sexist	3.0
<S> Chal gashti ki bachi randi chorni <S>	Sexist	4.0
<S> Lil Gashti mera mask gand me lelia tha tune <S>	Sexist	4.0
Or <S> tu certified gashti hy <S>	Sexist	3.0
Fake hy ye <A/O> gashti ka bacha <A/O>	Abusive/Offensive	3.0
Kon hai ye <S> gashti <S>	Sexist	3.0
<S> Aap ka gashtpuna is still on the top ğŸ¤ªğŸ˜ certified gashti <S>	Sexist	4.0
Announcement: I will block all those who bring this <S> Raza gashti <S> on my timeline through like or reply or retweet.	Sexist	3.0
RT : <S> Maryam Nawaz Gashti <S>	Sexist	3.0
<S> Gashti ne batatin bhi gashtion wali karni hoti hain <S> <S> ...shadi se pehlay bhaag tu gai safdar awan ky sath...pata bh kitni ratain guzari us ky sath... Bitch <S>	Sexist	5.0
oye <A/O> thandi gashti k bache <A/O> dekh tere baap ne kia pakra hath me <A/O> patwari khote khane wali nasal tere baap ne mask pakra he ise N95 Mask kehte bhosri wale k bache <A/O>	Abusive/Offensive	5.0
<S> Gashti gand marwata pakiri gai per ajj patwariyun ki ama ha <S>	Sexist	5.0
<S> Aur pakistan ki cetified Gashti suna hai Nawaz Sharif kay ghar paida hui hai <S>	Sexist	4.0
<S> garage wali gashti <S> sara paisa chori kr k dosro pe ilzam lagana chootya pan hai	Sexist	3.0
<S> Ye penyak Gashti Lahor ki Gashti Heera Mandi Ki Kanjri Maryam safdar ko phansi Deni chahiye ğŸ¥¾ <S> <S> ye penyak Gashti foj pa Bonkti Hai is Ki maa chodni chahiye is ko phansi Deni chahiye ğŸ¥¾ğŸ‘¢ğŸ‘ğŸ¥¾ğŸ‘¢ğŸ‘ğŸ¥¾ğŸ‘¢ğŸ‘ğŸ¥¾ğŸ‘¢ğŸ‘ğŸ¥¾ğŸ‘¢ğŸ‘ <S>	Sexist	5.0
<S> Ye penyak Gashti Lahor ki Gashti Heera Mandi Ki Kanjri Maryam safdar <S> na Bray se Bolne ka tariqa na Bat karne ka tariqa or <S> Geraaj ma foj se chadwa chadwa ke foj pa Bonkti Hai Zamane Ki Gashti Maryam safdar ko phansi Deni chahiye <S>	Sexist	5.0
Aur <S> duniya ki pahli gashti <S> jo pm banana chati ha aur <Rel> patwari harami eis ka pecha khara han lanat <Rel>	Religious	3.0
<S> Maryam safdar Ek number ke Gashti hy <S>	Sexist	3.0
<S> Tum Pakistan ki certified gashti ho <S>	Sexist	3.0
<A/O> Mir gashti k bachy... <A/O>	Abusive/Offensive	3.0
<A/O> Gashti ki puttar <A/O> <S> yahan tera thoko Imran khan kahan de aa gya haram zadi ranndi <S>	Sexist	3.0
<A/O> tari beti phuda kisy gashti da bapppğŸ˜¡ğŸ˜¡ğŸ˜¡ğŸ˜¡	Abusive/Offensive	5.0
<Rel> Gashti ki aulad Ch. Fawad Tere farzi mazhab aur teri Kaum Ki MKB, <Rel> My sincere apology	Religious	4.0
<S> Gashti <S> tumhe 18 march ko phir haraye ge aur tujhe muu chupane ki jaga nahi milegi	Sexist	3.0
<U> Iâ€™m not a gashti <U> and i donâ€™t remember him being a friend as well	Untargeted	3.0
Ja dafa ho <A/O> kisi gashti ka bacha <A/O>	Abusive/Offensive	3.0
waaah <S> gashti <S>	Sexist	3.0
<S> Gashti <S>	Sexist	3.0
<S> Lahor ki Gashti Heera Mandi Ki Kanjri Maryam safdar ko or India ka Eajent kashmir ka Sodagar Penyak gaddar Molana Diezal ko phansi Deni chahiye ğŸ¥¾ğŸ‘¢ğŸ‘ <S>	Sexist	5.0
Rameez raja commentary kartey hoey <Rel> harami pan poora kar raha hai. <Rel>	Religious	3.0
<Rel> Ingram harami bh out hgia <Rel>	Religious	3.0
<A/O> Tum maa chudwao aur kam karoo.nahe tou behn ke dlali karo. <A/O> Dr ho Dr banoo. <A/O> bakwas ke tou maa behn sab chudwa lo ge. kutte ke bache bhonki ja ra hae kab sae. <A/O> <Rel> nus nawaz de harami bache <Rel>	Religious	3.0
<Rel> 2 taky k harami bakwas bnd kr Ni to tere zaban khench lon ga <Rel>	Religious	3.0
RT : <A/O> Is lallu <A/O> ye sab faltoo topic dikhte hain, ignore all other important burning topics. <Rel> El number harami. <Rel>	Religious	3.0
RT : AJEEB POLIO KE MAREEZ HAIN <Rel> SAB K SAB HARAMI <Rel>	Religious	3.0
#LQvKK <Rel> kutta harami dalla <Rel>	Religious	4.0
<Rel> Bade harami ho tum bete <Rel> OUR INSPIRATION RUBINA	Religious	3.0
<Rel> Kutty ka bacha harami <Rel>	Religious	4.0
<Rel> Elsa kutti harami chutiya <Rel> ihu ğŸ˜	Religious	5.0
<S> Bilawal khusra <S> jete to shafaf election jabki pti 1 seat jete to dhandli. tum jese khusre ko kon vote dega ? <S> hejra bilawl zardari harami <S>	Sexist	5.0
<Rel> Geo hai hi harami <Rel>	Religious	3.0
<Rel> Yeh harami bik gya hai <Rel>	Religious	4.0
<Rel> ITNA CHUTIYA CAPTAIN HARAMI DALA <Rel>	Religious	4.0
<Rel> Randdibaaz Harami Hindu Uttar Joota Maar Joota <Rel>	Religious	5.0
RT : Muhabbat haram nh <U> log harami hein;ğŸ™‚ <U>	Untargeted	3.0
<U> harami bekaar wahiyaat zaleel ghenaona darpok <U>	Religious	4.0
<Rel> Munafiq kahin ka <Rel> ğŸ¤­	Religious	3.0
<Rel> Ya alkah hum ko bais or lafafa or personal grudge or munafiq sahafion se najat de. Unko gharq kar. Unko ko tabah o barbad kar <Rel> Sab bolo ameen Ameen summah Ameen	Religious	5.0
<Rel> Mullan munafiq <Rel> ko hr cheez halwaaa hi lagay ga	Religious	3.0
<Rel> Munafiq hainye sb, <Rel> propoganda master	Religious	3.0
Apni aur apney khandaan ki gurbat ki baat kr rehey ho <Rel> munafiq <Rel>	Religious	3.0
<Rel> Munafiq tu ap log ho <Rel> jo presiding officer ko kidnap kia	Religious	3.0
<Rel> Munafiq <Rel>	Religious	3.0
PTI k apne members agar andar ki baat bta den to Woh jhoote hain lekin tu aur tera leader sara din Chor dakoo ki gardan baghair sboot parhen to tum log Sadiq Ameen.. <Rel> Shut ur gutter mouth.. jhoot bak bak k ilawa Teri kia khidmat hain Mulk k lie.. Sharam. Kro..munafiq.. <Rel>	Religious	4.0
<U> Duniya hai he munafiq <U> ğŸ™‚	Untargeted	3.0
Qyamat ka intzar krna he bhtr hai yhan py koi kisi ki awaz nahi sunta <U> sub munafiq hai!! <U>	Untargeted	3.0
Dukh or takleef jase azmaish ALLAH sirf un logon ko deta jinko apny qareeb karna chahta ho. Toxic people se mtlb Quran me munafiq hain jin ALLAH ne mominin ko ase logon ko dost na bananay ka hukam diya	Neutral	0.0
<S> yani larkiyan munafiq hoti <S>	Sexist	4.0
<Rel> Munafiq mir <Rel> k show mein janay k faida nahi wese yeh khud ppp k sath milaa hoa hai	Religious	3.0
<Rel> Tum Jhooti aur hud darjay ki munafiq ho Nani. <Rel> Jail sy bahir ho iss liye kyu k iss mulk main qanoon nam ki chez nahe hay aur qanoon b isi liye nahe hay kyu k tumharay abby chalatay rahay iss mulk ko. <Rel> Allah ka azab aye ga tum logon py InshaAllah. <Rel>	Religious	5.0
<Rel> Pti clean sweep two poling station Now munafiq will not tweet about it <Rel> PS JJP Deslani PTI 680 PPP 00 Ps kiari Pti 416 Ppp 0 #221	Religious	3.0
<Rel> Aik No ka Munafiq banda <Rel>	Religious	3.0
Es salman azam ka muhallay me hee pTi na hra dya hab inku... <Rel> Munafiq molvi <Rel>	Religious	3.0
"Someone said this not remember the real name "" Agar aik shakhs ko sab hi pasÃ nd krin gy to beshak wo munafiq ha"" Its a quote"	Neutral	0.0
<Rel> Sari bqwas jhoty munafiq log <Rel> koi vote chori ni hoa.... <A/O> Choron ny khud phly golyian chliyen kr ab bqwas kr rhi <A/O>	Religious	4.0
Yahan to munafiq b murshad bny phirty hyn to muqasar b bn gye to konsi bari bat ğŸ¤ª ğŸ™ˆğŸ¥±	Neutral	0.0
Bat to ap ke kamal h yakeen krn Par Afsoos !! Jin logo ko pany agy koch nnzr e na ata ho onhy in bato ke kya smj Hmary Mashry m log smjty hn k bs Muslman hona kafi h Ary baiii Muslman ho to kam b to Muslmano valy kro Jahum m Kafir ka darja opr h mager Munafiq ka os sy nichy !!!	Neutral	0.0
Lekin ap ko kidnape bhi tw nahi kiya hua hoga kisi ne tw aap bahar niklein case file karein haqoq ke khilaf ya kisi NGO se contact karein. So simple hai mujhe sirf is chez se masla hai ke jism ke liye azadi manga ke jis marzi mard ke sath jo marzi karein koi pochuy na.	Neutral	0.0
Orat na chaha to doopta chor kuch na pehna ho to bhi mard jurat nai kr skta	Neutral	0.0
everyone in family knows about this friend of mine and half of them thinks weâ€™re in a relationship or smth. jitna main usky baray main jaanti hun na mera to mard naam ki cheez sy aitbar hi uth gya hai bhai sahab! ğŸ˜‚	Neutral	0.0
Hahahhahaha <S> tu to bra e na Mard nikla <S>	Sexist	3.0
<S> Chotiay na Mard apni Gandi tabiyat show krty Phr roty <S>	Sexist	5.0
<S> Na mard DulhağŸ˜Š. <S>	Sexist	3.0
Mask k sath parchi bhi hai <A/O> dallay <A/O>	Abusive/Offensive	3.0
<A/O> Dallay <A/O> mask ay...	Abusive/Offensive	3.0
<A/O> Is khabees dallay ko sar e aam media k samnay jootay laganay chahiye. <A/O> sir jago	Abusive/Offensive	4.0
<A/O> loru sare k sare ajeeb madarchoud na hoon toh dallay ke bache. <A/O>	Abusive/Offensive	5.0
<A/O> Dallay <A/O> kon hein yeh.. ğŸ¤¬	Abusive/Offensive	3.0
<A/O> Ye chutiya pa khi or ja k kro <A/O> yha ni chly ga ğŸ™‚ now get lost u all <A/O> assholes <A/O>	Abusive/Offensive	4.0
Flex mar k cool ni <A/O> chutiya lg rha h <A/O>	Abusive/Offensive	3.0
<U> Ye itni.chutiya app q ha ? <U>	Untargeted	3.0
<A/O> Twitr pr buhat buhat chutiya** awam zinda ha abh <A/O> ğŸ˜‚	Abusive/Offensive	3.0
<A/O> Yeh r level ka chutiya h <A/O>	Abusive/Offensive	3.0
<A/O> Bakwas Ni krtay bilawajah ki <A/O> ...main v mohajir family sy hoon...lkin yeh yaad rakho k nawab of bawalpur ny kaisay support Kiya Pakistan ko...or meherbani kr k unity promote kro... <A/O> (chutiyon k sath Chutiya Ni hotay) <A/O>	Abusive/Offensive	4.0
<U> Ye kya chutiya stadium banaya hai <U> Light he kharab hai	Untargeted	3.0
Wtf ğŸ˜‚ğŸ˜‚ğŸ˜‚ <A/O> chutiya hi lag rha <A/O>	Abusive/Offensive	4.0
Seedhe muu tum se bat hoti nhi Har jga koi gali le atte ho Kam se kam sensible tareqee se to behes krlo Subha se bas galia hi di ha or tum ne kch ni kia Ye apni khush fehmianapne rk rkho yaqeen krna ha to kro ni to apni jga pr rho Ab <A/O> tumari chutiya logic <A/O> ka me reply ni krra	Abusive/Offensive	3.0
<U> Spitting facts make you chutiya in this society <U> ğŸ˜Œ	Untargeted	3.0
<A/O> Chutiya tha mağŸ¥²ğŸ˜‚ <A/O>	Abusive/Offensive	3.0
Dear bestfriend <U> Tu chutiya hai toh hai <U>	Untargeted	3.0
<A/O> Chutiya afridi <A/O> ki bhejta tolly mar jatta	Abusive/Offensive	3.0
<A/O> Both are chukku and chutiya <A/O> , we don't know which type of chukkuism is acceptable and which one is not , totally out of our league. So we chillin ğŸ˜	Abusive/Offensive	3.0
RT : <A/O> Yei chutiya larki <A/O> haar aik sai panga leti hai	Abusive/Offensive	3.0
<A/O> ajeeb chutiya hai. <A/O>	Abusive/Offensive	3.0
Tuanu ty Nawaz sharif or zardari personally lai k janat main jain gain <U> #chutiya samjha hai k <U>	Untargeted	3.0
mere ilawa puray pakistan ko meri itni parwah kyun hai bhae? I donâ€™t know what it is but I really donâ€™t see myself being with anyone or sharing my life with anyone meri marzi beshak main 40 saal ki ho k sochun ya kal hi soch loon. <U> ajeeb chutiya zehniat k log hain <U>	Untargeted	3.0
<A/O> Chutiya hen aap <A/O>	Abusive/Offensive	3.0
<A/O> Abe modi k chutiya berojgar bete <A/O> inme se kisi ka fayada hua kya sb mare hai log isne pulwama attack se vote liye ram mandir k nam pr vote liye Muslim ko markar tume khush kia waha vote liye ab kisaan ko marwana shuru kr diya hai ab dekho tumari taraf bi modi aata hoga be careful.	Abusive/Offensive	3.0
<A/O> Facebook chutiya zuckerberg madarchod <A/O>	Abusive/Offensive	4.0
Sir Chutiya na dy hm Fsc Students ko December tk ki preparations ka time dyğŸ™ğŸ™	Neutral	0.0
<A/O> Ye inthaa ka koi chutiya banda hai. <A/O> Aj tak iski koi bat such nai hvi	Abusive/Offensive	3.0
<A/O> Kr lia chutiya pan ? <A/O> Unfollow ? <A/O> Woi awkaat e tunhri <A/O> nahi a ky tumhy fb dia jai !	Abusive/Offensive	3.0
<A/O> Chutiya owner chutiye supporters <A/O>	Abusive/Offensive	4.0
Haha funny to see <A/O> both chutiya teams playing <A/O>	Abusive/Offensive	3.0
Aby <A/O> itni chutiya performance #QG <A/O>	Abusive/Offensive	3.0
<U> Yeh jo chutiya celebration thi, <U> yehi wajah hai why everyoneâ€˜s against Karachi Kings. #KKvQG #HBLPSL2021 #PSL2021 #PSL	Untargeted	3.0
<A/O> Chal chal chutiya Saly Gando.. <A/O> <A/O> ISI Hain Tmhry jasy gando logo k lia <A/O> so hm shakoon m3 warna hm na <A/O> tmhri gand bi band kr dni thi <A/O>	Abusive/Offensive	5.0
<A/O> chutiya log hain ye <A/O>	Abusive/Offensive	3.0
<A/O> Ajeeb chutiya insaan ho tum <A/O>	Abusive/Offensive	3.0
RT : <A/O> Endia**chutiya â­â­â­ <A/O>	Abusive/Offensive	3.0
<S> tmri gand in dono sy zaida mashor hy <S>	Sexist	3.0
Sorry main yahan gand nhi chahta	Neutral	0.0
<A/O> Muhammad qasim gand** <A/O> kon ha??	Abusive/Offensive	3.0
Beta bat krny sy pehly apna geryban mein janka kro or us sy b pehly bat krny ki tameez sekho. wo jesa b ho jo b ho prime Minister hy. <A/O> yaha sab k samny apni tarbiyat na dikhao. <A/O> <A/O> or rhi bat okaat ki to tery jesy usny kuto ka gand uthany k liey rkhy hoty hy. <A/O>	Abusive/Offensive	5.0
<A/O> Latak nhi gand mara <A/O>	Abusive/Offensive	3.0
Me genuine btt kr ra ye <U> logg gand ko pasand krtyğŸ˜¬ <U>	Untargeted	2.0
Pehle Facebook phir Instagram aur abh yahan pr bhi kuch sharam kro #shameamjad shukr he abhi snapchat ka pta ni <A/O> aap jase logon ko warna wahan pr bhi gand marte <A/O>	Abusive/Offensive	3.0
<A/O> Tumhare bap ka pesa hy? <A/O> <A/O> In madarchod luteroun <A/O> ki khatir awam ka pesa brbad kro gy tum? Tum kro gy ye hrkat? <A/O> Jis madarchod ko zyadah aag lgi hy re election ki wo ma chudaye apne <A/O> pese laye or phir Kahy k usko re election krana hy wrna <A/O> gand me muh de kr chup chap betha rahy! <A/O>	Abusive/Offensive	5.0
<U> Yh kya lunpanti h. <U> Yh chz related h PSL k. <U> Gand mein dm krky rkha h. <U> #Pawrikhtam	Untargeted	4.0
<A/O> Gand mara <A/O>	Abusive/Offensive	3.0
Yeh sarfaraz trending 1 per kiya kar raha ha... <A/O> moti gand <A/O>	Abusive/Offensive	3.0
<A/O> Bhosri kay zyada gand na phulao ma chod dain gay tumhari <A/O> kam karo apnağŸ˜‚	Abusive/Offensive	5.0
Ya dkho <A/O> gand dany k leay tayar <A/O> ğŸ˜‚ğŸ˜‚ğŸ¤£ğŸ¤£ğŸ¤£	Abusive/Offensive	3.0
MQM ka gand Pakistan kisi aur area main nahi ha, ye wali begairti sirf karachi aur muhajiron k hisay main aye ha.	Neutral	0.0
Aur <A/O> tum bss har neighbour sy gand mrwany k leay <A/O>	Abusive/Offensive	3.0
Abbi tum logo ny hamara qarza daina h <A/O> zayada gand na phulao <A/O> ğŸ˜‚ğŸ˜‚ğŸ˜	Abusive/Offensive	3.0
<A/O> teri gand ma kia kharish ha tu wo bata <A/O>	Abusive/Offensive	3.0
Twitter pe gand na dalo ğŸ˜‚ğŸ˜‚ğŸ˜‚	Neutral	0.0
Jalane wala kaam chod diya hai maine abb ğŸ™‚	Neutral	0.0
<A/O> Chutiye act bn chuke hai ye farm bills <A/O> <A/O> Modi maa chod jae ga Teri tere ko pta bi ni lgega <A/O>	Abusive/Offensive	5.0
Totally agreed with you,mene bhi isi wajah say shipping chod di thiğŸ™‚	Neutral	0.0
Chod in sb baaton ko Shehnaaz ki kl shooting start hai uski timeline pe sb acha acha dikhe isliye uski tareef vale Good luck vale tweet kr bs	Neutral	0.0
Deepak ji pak k piccha chod do bhai	Neutral	0.0
<A/O> pen chodğŸ˜‚ğŸ¤£ <A/O>	Abusive/Offensive	3.0
Toh tujhe konsa chod dugi mai	Neutral	0.0
<A/O> APKI MAA CHOD GEYA ZAMANA?ğŸ˜‚ <A/O>	Abusive/Offensive	3.0
<A/O> Abai lun ke muh waly <A/O> quetta ke ghar ma beth kar <A/O> baatein mat chod bata address abhi ek phatan ki foj bhejta <A/O>	Abusive/Offensive	4.0
<U> B c stand for bhan chod <U>	Abusive/Offensive	3.0
Zee news chod kar The hindu, indian express padhna shuru kar do... Kam se kam kisano k hakk me nhi to, modi ki bhakti toh chodo ge.	Neutral	0.0
HwwwwğŸ¤­ Pher lerki ko Chey ke asy mard ko chod de....	Neutral	0.0
Song Dekh Teri Jal gai hai na isliye to bol raha hai <A/O> kutte bakwas karna chod <A/O>	Abusive/Offensive	4.0
Kb Jan chod ga dil karta hai galiy do	Neutral	0.0
Bilkul sahi, zindgai ki sari pareeshaniya hum pr havi hi isilye hoti ha kyu k hum namaz or Quran ka sath chod kr bethe ha May Allah lead us to the right path!!Ameen	Neutral	0.0
Woh chod one week pehle hi new liya tha ğŸŒšğŸŒš Abb mummy ko kaise btau kand ho gya ğŸ™‚ğŸ™ƒ	Neutral	0.0
<Rel> Khanzeer <Rel>	Religious	3.0
RT : <Rel> Haramio <Rel> dukh he dena seekha hai tm ne.. Performance de ni rhy... #LQvQG	Religious	3.0
<A/O> Saali <A/O> mere pass zeher khane ke paise nhi hai tujhe iphone chahiye	Abusive/Offensive	2.0
Zindagi ek pall mein saali yun palat gayi hamari....	Neutral	0.0
<A/O> Saali pehle tujhe marugi phir usko <A/O>	Abusive/Offensive	3.0
Every saali when jiju calls : Suchi mn aisi hoti hn Kiya saali? ğŸ˜‚	Neutral	0.0
Ab Ap soch rhi hun gen kash m bhi Imran Khan ki Saali hotiğŸ˜‚ğŸ˜‚ğŸ˜‚	Neutral	0.0
<A/O> Saali <A/O> mai khud kal aye hu break per thi	Abusive/Offensive	2.0
Bhai hai <A/O> saali <A/O> mera chota	Abusive/Offensive	2.0
Just one question: Ye saali k pas jija ka number q hota hai? And why she has to start a convo with him?	Neutral	0.0
<A/O> Saali <A/O> bas kar pehle hi koi nhi bol rha ğŸ˜‘	Abusive/Offensive	2.0
<A/O> Saali <A/O> tu jiju ka birthday bhul gye ğŸ¥ºğŸ¥º	Abusive/Offensive	2.0
Shahbaz gill tumhary muum pr <Rel> 100000000 bar laanat ho <Rel> tu b kam h.ğŸ–ï¸ğŸ–ï¸ğŸ–ï¸ğŸ–ï¸ğŸ–ï¸ğŸ–ï¸ğŸ™ŒğŸ™ŒğŸ™Œ	Religious	3.0
<A/O> Aur wo already gundy hain, in ko koi farq pry ga, <A/O> <A/O> kanjer ko kanjer Keh b dain to kanjer ko koi farq ni prta <A/O>	Abusive/Offensive	5.0
<A/O> Yeh kanjer log <A/O> Apny mafad k ley asy ee ho jaty hn	Abusive/Offensive	3.0
We had this game man than <A/O> fuckin tanvir happened. <A/O> <A/O> Is kanjer <A/O> ko bench par rakhna hai baki k matches.	Abusive/Offensive	5.0
<Rel> oh lanti <Rel> parchment nahi mask hay besharam insane haya kar	Religious	3.0
Sharif sahib thodi himat kro wapis aajo .. <Rel> Lanti <Rel>	Religious	3.0
<Rel> Kesa lanti insaan ha tu yr <Rel> <Rel> lant tre bachi zndge ty vi <Rel>	Religious	5.0
This is how you do it <Rel> Lanti <Rel>	Religious	3.0
<Rel> Hamza he hi lanti <Rel>	Religious	3.0
<Rel> Lanti loog hain PPP waly aur Hamid mir <Rel> <A/O> in kutun ko sirf PTI se masla hai aur us pe bhaunkny k pesy bhi milty hain inko paltu kuty hain yeh. <A/O>	Religious	5.0
<Rel> Lanti <Rel>	Religious	3.0
<Rel> Kesa lanti hai ye <Rel> ğŸ¤£ğŸ¤£ğŸ¤£ o last over hai bhai ğŸ¤£ğŸ˜­ #PZVMS #hblpsl6	Religious	3.0
<Rel> Ajeeb lanti insan h <Rel>	Religious	3.0
<Rel> Lanti urat shtan <Rel> <Rel> ..kuti ferdos ur harmi S.Gill <Rel>	Religious	5.0
<Rel> Lanti <Rel> jab teri hakoomat thi tab bhibpti nay dhandhli ki thi ğŸ˜‚	Religious	3.0
<Rel> Lanti insan. <Rel> Teri party kahan hai?? pti muqably me to hai	Religious	3.0
Agar tum kisi ko apni adat dalwa k ek dum se bdal jaty ho, to <Rel> tum lanti ho! <Rel> ğŸ˜ğŸ‚	Religious	3.0
<Rel> Abad shurli lanti <Rel>	Religious	3.0
<Rel> O jhail jhoty ghtiya insan lanti. <Rel> jahan noon jetty woh election theek jahan hary wahan dhandli	Religious	5.0
<Rel> Sharm kar lanti inshan <Rel> jhoat pay jhoat	Religious	4.0
O juthy insaan ab b 2800 ki hy <Rel> lanti <Rel>	Religious	3.0
Ye bi deko <Rel> lanti <Rel>	Religious	3.0
<A/O> Lun k upr a jao <A/O>	Abusive/Offensive	3.0
RT : Ijazat ho to Avi change kar lun? ğŸ™‚ğŸ‘‰ğŸ‘ˆ	Neutral	0.0
Phly me tu dekh lunğŸ˜‚ğŸ˜‚	Neutral	0.0
Leaving Twitter No one Care For Me Not Engaging on Mah Posts Es se Acha Math Improve kar lun ApniğŸ˜	Neutral	0.0
Kya ab dubara wahi lga lun ğŸ˜¬	Neutral	0.0
Pichle match wali technique apnaai ...ğŸ˜‚ Pressure men over niklwa k one down runs KER lun ga ... ğŸ¤£ğŸ¤£ğŸ¤£ğŸ¤£ğŸ¤£ğŸ¤£ğŸ¤£ Aagy PHR	Neutral	0.0
Chumi shumi le lun koi masla to nhi	Neutral	0.0
<A/O> Lun le le mera <A/O>	Abusive/Offensive	3.0
<A/O> Lun mera <A/O>	Abusive/Offensive	3.0
Hahahhahahahaha <A/O> tu lun <A/O>	Abusive/Offensive	3.0
<A/O> HOD bhi lun admi hai <A/O>	Abusive/Offensive	3.0
Lmao and jisky tu baat karaha meri ussy baat hochuki lun ğŸ˜‚ğŸ˜‚ğŸ˜­	Neutral	0.0
<U> Sab lun <U>	Untargeted	3.0
<A/O> SHABAZGIL yr mother fucker hy r merry lun py bhii tera jesa bandar nach sakta fikar nii nachtty rahu <A/O>	Abusive/Offensive	5.0
Mn lun gi but ap se nai...apni pocket money se...	Neutral	0.0
<A/O> Lun khao <A/O>	Abusive/Offensive	3.0
Handsfree b nhi mil rheen warna arijit singh ko hi sun lun	Neutral	0.0
Agar masla share kr lun to sun liya kro mashwary na deny beth jaya kro.	Neutral	0.0
Aeay na kaho wrna badal lun gi ğŸ˜ŒğŸ˜‚ğŸ˜Œ	Neutral	0.0
<U> Lun mera trying. <U> Unprofessional captain ever. So Ricky, Smith, Dhoni, Inzmam, Cook etc didnt know how to try to save the game? Lol	Untargeted	3.0
Sarfaraz is already not feeling happy. <A/O> Lun Taptaan <A/O>	Abusive/Offensive	3.0
Main sambhal lun gi isy tum match dekho kahi gayle out na ho jayğŸ˜‚	Neutral	0.0
<Rel> Ramdev teri bhen di lun kutte di sala kana harma da dalla <Rel>	Religious	5.0
Bass ab nah roien kar lun gi change ğŸ˜­ğŸ˜‚	Neutral	0.0
Mathay pe likhwa lun kaho tou ğŸ¥°ğŸ¤©ğŸ¤ğŸ¤ğŸ¤ğŸ¤ğŸ¤ğŸ¤	Neutral	0.0
Mn kese man lun ğŸ˜”ğŸ˜¤ğŸ˜­ Agr sach mn ha to Congratulations ğŸŠ Mjhe invite hi nhi kia ğŸ˜’	Neutral	0.0
<A/O> Lun ty charh <A/O>	Abusive/Offensive	3.0
Han han socha sb sy puch lunğŸ˜‚	Neutral	0.0
Bore ho rhi hu , dil kr rha hy psl ka anthem bna lun.	Neutral	0.0
Shrm kr <A/O> phudi k <A/O> shrm kr	Abusive/Offensive	2.0
<S> Mujy phudi chatny ka mooqa doo na plzzz <S>	Sexist	3.0
<U> Phudi ko trss gya hy mera lund <U>	Untargeted	4.0
mujy b aik moqaa dien plzzzz <A/O> mie b apki bivi ki phudi chatna chahta hooo <A/O> plzzzzz	Abusive/Offensive	3.0
Heena g, Just <S> tumhari phudi ne mere lunn ko email ki hai k tumhar phudi mera lunn lene k liye tiyar hai. <S>	Sexist	4.0
<A/O> phudi k bhenchod dm a tu <A/O>	Abusive/Offensive	4.0
<A/O> Phudi kay <A/O> police station model town lgta haiğŸ¤¦ğŸ»â€â™‚ï¸	Abusive/Offensive	3.0
soja <A/O> phudi k <A/O>	Abusive/Offensive	3.0
To <S> ja k phudi Marwa. <S>	Sexist	3.0
Kash <S> Sobia apki phudi chatny ko mil jay <S>	Sexist	3.0
<A/O> Teri mama ki phudi ma bhi tb hi to tery jesa gandu duniya ma dydiya <A/O>	Abusive/Offensive	5.0
<Rel> hramzady, <Rel> try liye itna hi kafi hy k <A/O> ganja mafroor mujrim hy or tri maa ke phudi marny wla is waqt PM Pakistan hy rok sko to rok lo <A/O>	Religious	5.0
Ahh <A/O> phudi k Tu ku behan denya aya? <A/O>	Abusive/Offensive	3.0
<U> Nahi saff phudi pasand hia chatney aur chusney me maza ata hia <U>	Untargeted	4.0
Haq nahi marta <U> gand aur phudi marta hon <U>	Untargeted	4.0
<S> Iss se behyar hia mujh se phudi chuswa leya kren <S>	Sexist	3.0
Waoooo <S> yummmy phudi and asss kash mera lund hta is hole me <S>	Sexist	5.0
<S> Phudi merwany k bad, maryam safdar khush-gawar mood me <S>	Sexist	4.0
<S> Teri phudi maarny ki rat to hr rat mani jati hai gashtiye <S>	Sexist	5.0
<A/O> Phudi k <A/O> tu ne bahut acha kaam kia tu samajta hy	Abusive/Offensive	2.0
<S> Gul di phudi ni phuday wich kutay da lun <S>	Sexist	5.0
<U> Meray phudi koye chatay chodnay se pehlay <U>	Untargeted	5.0
Sirf <U> Lun r phudi <U>	Untargeted	4.0
Aap fifty kar lain Maqsood Bhai. Rizwan ki kher hai ğŸ˜ #LQvMS	Neutral	0.0
aap shehnaazians ho ya sidnaaz fan	Neutral	0.0
Main hamesha krti hu ğŸ‘‰ğŸ˜Šaap tension matt loğŸ’«ğŸ’«	Neutral	0.0
Bhudapa he aap serious na le esa hojata he	Neutral	0.0
Allah bless you.. Allah aap pe kram rkhy.. Ameen	Neutral	0.0
Aap bhi thi kuch? ğŸ˜­	Neutral	0.0
I know maar khaayi me yahn baat variations ki kar raha jo last time aap ny kaha tha k drift par zinda hai leg spin googly koi nhi hoti ab	Neutral	0.0
Wah wah kya baat hai aap ki	Neutral	0.0
Aap to kuch bhi dedo dono mein se chlegaağŸ˜Œ	Neutral	0.0
Bhai Yaha Zainab Jb Bhi ati Out Hota Aap Pichly Matches Dekho Waha Jb Jb Zainab Ayi Out howağŸ˜‚ğŸ˜‚ğŸ¤£	Neutral	0.0
Aap pareshani Ki Baat Karte Hain aap Logon ke network Ne to zindagi kharab kar di Hai Hamari	Neutral	0.0
Haa na woii to thk kha aap neğŸ˜ Aisy thori na hota âœŒğŸ»	Neutral	0.0
Waqas bhai aaj aap Kay qalandars ki hamaray Sultans Kay hathoun tuning ho rahi hai.	Neutral	0.0
Are you kapil sharma qk Acha mazak karti ho aap	Neutral	0.0
Bhai Bethy Hoo Aap Bhi..?ğŸ˜‚ğŸ˜‚	Neutral	0.0
Dekhte ha aap ki kaptaan ki toh chutti kar di ab hafeez ko uranağŸ˜‚	Neutral	0.0
Okay dhondhty hy aap k liye	Neutral	0.0
Qusoor aap logo ka ni qk is time tum log mars par ho ğŸ˜‚ğŸ˜‚ğŸ˜‚	Neutral	0.0
Sachi baat ye hai k aap k tweet pr hi reply ka mza haiğŸ˜…	Neutral	0.0
Allah talah aap ko kamiyab kry ameen	Neutral	0.0
Yeh Dp mein Aap Ho ğŸ‘€ğŸ™Š	Neutral	0.0
saqib bhai aap ko bula rahe ye log	Neutral	0.0
Ye mein ni kru ga ye aap khud hi smjh lu ğŸ˜…	Neutral	0.0
Alhamdulillah ğŸ˜‡â£, but sir agar aap na poori ki conference dekhi ha to ap na dekha hoga ka kis tarha sa india pakistan ko Blacklist karny ki full koshsih krta raha ha unki zuban pr siwya pakistan ko balcklist krna ka or koi agenda nhi tha ham log pechy q?	Neutral	0.0
Ye aap ko aaj yad aya ğŸ˜¬ğŸ˜‚ğŸ˜‚ pehle soye hoye the	Neutral	0.0
Aap tou meri bestie hoğŸ˜”ğŸ‘‰ğŸ‘ˆ	Neutral	0.0
I m not single even though I respect other's emotions..... Isi liye pehly tameez sy poch thak kon ho aap......	Neutral	0.0
Astagfirullah ğŸ™‚ ğŸ˜‚ ğŸ˜‚ ğŸ˜‚ ğŸ˜‚ meny aapko pehli dfa dekh rha hn yr kon ho aap ğŸ™‚ğŸ™‚ğŸ™‚ğŸ™‚ğŸ™‚	Neutral	0.0
Ooo behn kon ho aap ğŸ™‚	Neutral	0.0
RT : Aik din aap youn hum ko mill gayen gayğŸ’•	Neutral	0.0
Alhumdullilah Aap batain ğŸ˜Š	Neutral	0.0
Mubarak bhai aap ko bhi bubat buhat	Neutral	0.0
MeğŸ˜’ğŸ˜‚ğŸ˜‚aap k followers ziada ğŸ˜‰ğŸ˜…	Neutral	0.0
Khuda ka khauf nhe aap ko. Allah ap k ILM m izafa kre.... Ameen summa aameen	Neutral	0.0
Bhai jo zulm Aapki Yem yem Aap pa kr Rahi ha, oska kuchh Kro. Hmara time Kew waste krty ho. ğŸ˜©â˜ ï¸	Neutral	0.0
Aap khud hi Drop ho jao. ğŸ˜©ğŸ˜…	Neutral	0.0
RT : Agar Aap Saab 10 10 Rupay Mujy Easypaisa Krein Itna Acha Phone Loongi ğŸ˜¿ğŸ˜¿	Neutral	0.0
Aik din aap youn hum ko mill gayen gayğŸ’•	Neutral	0.0
yaar main mazaq kar raha tha, aap to serious hogaye ğŸ˜”ğŸ˜”ğŸ˜” will buy them 4 u on treet	Neutral	0.0
Ohh aap ko bhool gya ğŸ™‚ğŸ˜¢	Neutral	0.0
I agree k law banana chahiye but abhi aapka law yh hai k 1 martba player saza puri kar ly to heâ€™s eligible for team selection! Or agar aap is law k hoty hue 1 player ko khilaty ho or dosry ko nhi to yh ziadti hai! Allah bhi mauf karny ka kehta hai bhai	Neutral	0.0
saeem mubarakan aik gila hay aap nay mayray dm ka reply naheen kiya...	Neutral	0.0
Aap KO bhi MUBARAK ho	Neutral	0.0
ye bhi aap ho?	Neutral	0.0
Ameen sum Ameen ğŸ˜ same too bus aik request ziauru kroga aap sy	Neutral	0.0
Aryyy boss toh aap howe nağŸ˜‚	Neutral	0.0
Kia aap books parte hain ?	Neutral	0.0
RT : Isme bhi rajniti khel rahe ho aap	Neutral	0.0
I wonder aap khamosh hona kab start krein gay ;))	Neutral	0.0
youthyay appa, aap bhi aqal se kaam lain pti KO chorrrr dain	Neutral	0.0
Acha jee maan le aap ki baat. Ab Shukria nahi direct thanks hi kahon gağŸ˜œğŸ˜	Neutral	0.0
RT : Ameen behna aap bhi	Neutral	0.0
Krlia hoga ab chill kr rahi hongee.	Neutral	0.0
Nazar mar di na Ho gya ab bimar ğŸ¥ºğŸ¥ºğŸ¥ºğŸ¥ºğŸ™ŒğŸ»ğŸ™ŒğŸ»	Neutral	0.0
Mujhu lag ra rha kal sy garbad krien gy per ab Team to apni na Support to krien gyğŸ˜â¤â¤ğŸ’šğŸ˜	Neutral	0.0
Congratulation mubashar bhai	Neutral	0.0
Ab phr dekhna hai chal shuru ho ja ğŸ˜ª	Neutral	0.0
all good babe, ab dekh rahi. ğŸ˜›	Neutral	0.0
Ab bnda itna bhe kanjosi na kary agr mjy bola hota na ab tak main dey deta ğŸ™‚	Neutral	0.0
Ab thak chukay hain yeah qadammm, Chal ghar chalain meray humdum!	Neutral	0.0
chor ab lecture den ge awam ko?	Neutral	0.0
Ab toh yehi kaho ge tum log mera puttar aaj multan walay lorr walay ko mars se zameen par laa rahe hağŸ˜‚ğŸ˜‚	Neutral	0.0
Wo purani bat ab dekhi match ka pasa plty ga ye jo chenl gya hena hahah	Neutral	0.0
HAN AB DUBARA TWEET KRO JAO	Neutral	0.0
Jeete hue yar multanâ¤ï¸ğŸ’ª Ab baari ha janoobi punjab ki ğŸ˜	Neutral	0.0
Ab tum aisy kaho giğŸ™‚	Neutral	0.0
Ab kuch ni ho skta match bana dia ha rizwan nyâ˜¹ï¸â˜¹ï¸â˜¹ï¸	Neutral	0.0
Ab mai 1000km dor aao? ğŸ˜­ğŸ˜­	Neutral	0.0
"A 65 years old uncle stopped me while I was going to offer Junmah prayer""ibrahim aaj 2 matches hain na?"" beta Wo dish pe aur cable pe dikha rahe ab ki bar Aerial ooncha kia hai phir b Ptv sports nhi aaya"" Sky pe dikhane se sony pe dikhane se Doosre dekhen ge apne nhi"	Neutral	0.0
Nhi ab re election he hoga ajk kerwa ly Govt or 6 month baad ...	Neutral	0.0
RT : Teri Baho mein Ab mera Ghar hai This never gonna be OLD ğŸ˜­ğŸ˜­ğŸ˜­ğŸ˜­ğŸ˜­ğŸ˜­ğŸ˜­ Mineee Favourite RraHel Content ğŸ§¿ğŸ§¿ğŸ§¿ğŸ§¿ #HellyShah #Ishâ€¦	Neutral	0.0
Acha chloo g ab balls ziada miss hn ya out ho jaen saary players ğŸ˜	Neutral	0.0
Shadi hogi to tmko sab say phly bula longa ab theek hai?	Neutral	0.0
Chalo ab gussa thook do	Neutral	0.0
Rizwan ha khara toh match jab tak humare hath mein ha Sultans ğŸ˜ Ab baari ha janoobi punjab ki #LQvMS	Neutral	0.0
Koi nhi wadey bandey kr ley Ab hum un k kese ban jaen kia	Neutral	0.0
Ab ni girti wickets	Neutral	0.0
ğŸ˜‚ yaar ab pitch isi pitch par maar bhi khaayi hai ab pitch par daal do ğŸ¤ª	Neutral	0.0
Chalo ab chutti kro ğŸ˜‚ğŸ˜‚	Neutral	0.0
Please Lahore Samit Patel ko ly ana ab next! ğŸ˜¶ #PSL2021 #PSL6	Neutral	0.0
Aai aai ab interact hoga :-)	Neutral	0.0
drop emojis for meğŸ‘€ğŸ˜ŒğŸ˜Œ Crush!ğŸ¤¤ Cute!ğŸ˜ Dm meâ¤ Hot!ğŸ”¥ğŸ‘€ TharkiğŸ¥µ Best nature ğŸ˜ love you ğŸ™ˆ Marry me ğŸ˜ƒ Never seen you before ğŸŒ Nice personality â£ï¸ Friendship material ğŸ™‚ WelağŸŒš Stranger ğŸ™„ Btao ab ğŸ¥ºğŸ¦‹ #caapied	Neutral	0.0
Lahore Jb haar jae to mjhy bta dyna main Apni energy ab apny match k lye save kar raha hu ğŸ˜ #LQvMS	Neutral	0.0
Haan g ab kya khti hain???ğŸ¤£ğŸ¤£ğŸ¤£ Ist gone	Neutral	0.0
I don't even watch Cricket but ab to Multan hi jeety ga. ğŸ˜¤ğŸ˜¤ğŸ˜¤	Neutral	0.0
Bss ab yhi emojie chlai gi	Neutral	0.0
Then , they should separate sana from their dulasionaal Ship. And mera bhi ab yehi dil krta ha yar,Twitter is becoming toxic day by day	Neutral	0.0
Insha Allah ab jeetay gay ğŸ˜ğŸ¤	Neutral	0.0
Ab jiski ghoos ki kamai bandh ho gayi wo toh aesa hi bolegağŸ˜ğŸ˜‚	Neutral	0.0
Ab yehi kahe ga tu meri jan haar ko hazam kari aaj	Neutral	0.0
Ab mein na kia kaha hai ab ap ki team bad performance dekha rhi hai ğŸ˜‚	Neutral	0.0
Han ab sab kch zainab baji pe dal do ğŸ˜‚	Neutral	0.0
Koi kuch b kehy hum ap dono ke sth hain #sidnaaz humara pyar apke lye kabhi khtm nhi hoga 1 Year Of SidNaaz's First Post 1 Year Of SidNaaz's First Post	Neutral	0.0
Ye Sub Kuch Nhe Rahey ga Apke pass Jb ap Khud Kuch Nhe kar paiye gy Apny sath	Neutral	0.0
Jaisa mjje lga tha Apke mzak krne pey	Neutral	0.0
Auto generated hai bro. Maybe past days main itna interaction ni hua hoga apke account se. Is liay.	Neutral	0.0
Nawaz Sharif Bhai upset na hoon Abhi apke Nazrayati saathi Maulvi Fazl ur Rehman aur Mahmood Achakzai majood hain.	Neutral	0.0
Boht alaw khyalat hain apke â¤ï¸ Btw mei blkul hurt ni hua tha ğŸ˜‚ chill kro yar	Neutral	0.0
To apke abba ne anko apni hakoomat me q rakha	Neutral	0.0
Good night  sir sweet dreams 	Neutral	0.0
Yeh sawal larkio se bhi poocha ja sgta ha ... its not about honesty but maturity + itni aqal to hona k Bndaa pehchan lo wo apke miyar pr na utry to he/ she is s a cheat	Neutral	0.0
ğŸ˜‚apke khuwabon men koi hor ata ha na ajkal ğŸ¤ª	Neutral	0.0
Kuke apke pass love nhi ha	Neutral	0.0
batao apke kitne h?	Neutral	0.0
Hy guys please follow . She is a newbie and IA fb bhi aye gaa' apke pass. JAZAK ALLAH	Neutral	0.0
Bahi hum apke masoom fansğŸ¤§ğŸ˜‚	Neutral	0.0
Oh apke aur mere subjects same hain but meri uni nhi college ka naam twitter hai	Neutral	0.0
Shah G kya kehny apkeâ¤ï¸	Neutral	0.0
Suppoes kl apke shadi h ğŸ¥€ğŸ™ƒ What's your reactionğŸ‘»â¤	Neutral	0.0
Apki ankheinğŸ’• Apke rukhsarâœ‹ï¸ğŸ˜šğŸ˜­ğŸ˜­ğŸ˜­	Neutral	0.0
Beta Allah ky kamo ma hath na kro warna bhout bura ho ga apke sath	Neutral	0.0
RT : comments meto sare apke khilaf hen phir ue supporter kon hen jo nzr nahi arheğŸ˜‚	Neutral	0.0
Kya kehne apke toh phir ğŸ‘ğŸ»	Neutral	0.0
Hahaha matlb filhal apke pass hai he nai khardni hai âœŒï¸ğŸ’¯ğŸ˜‚ Acha batana phr mojhe main ache wali khared dun ga apko ğŸ’¯ğŸ§	Neutral	0.0
Good night ğŸ˜´ sir ji sweet dreams â¤ï¸â¤ï¸ take care ğŸ¤—ğŸ¤—ğŸ¤— to milte ha kal ......yhi sunsan twitter ki glio (street) meğŸ˜œğŸ˜œ.....apke bina to sunsan hi hota hağŸ™ğŸ™	Neutral	0.0
To konsa apke ghr a gye Sakoon se betho na	Neutral	0.0
khuda kry yah smile hamesha apke face pr ase hi rhy ameeeeeeeeeeeeeen suma ameeeeeeeeeeeeeen	Neutral	0.0
Bhaii template hogi apke pass yeh waali??ğŸ¥ºğŸ¥ºğŸ‘‰ğŸ‘ˆ	Neutral	0.0
Link Hai Apke Pas...?	Neutral	0.0
Apke k liye FC bnana hai kis name se bnau WE STAN RUBINAV	Neutral	0.0
You always cheer up so unexpectedly. ğŸ¥ºâ™¥ï¸ apke mun main ghee shakar gulab jamun.	Neutral	0.0
Apke chachu LONDON kb ja rhi hain? ğŸ˜ª	Neutral	0.0
Kuch ni bs apke kay interaction ka intezar	Neutral	0.0
Apke abba bhi shamil bhi shamil hain pakistanis me	Neutral	0.0
Happy birthday dear ğŸ‚ May Allah bless you and your family stay blessed and strong more power to you â¤ğŸ¤²ğŸ» hmesha Khush rho Allah pak Apke naseeb ache kre Aameen... Lala Plzz wish him.. She is ur biggest fan â¤	Neutral	0.0
Jab ap galt faisly kro or apke palyer perform na kren to aesa he hota hai , Sarfraz jazbati kbi b ni tha bs thda lalach me aya hua or k6 Hafeez Tweet k wja se umeed hai sab bhtr ho ga , But Quetta last nbr p he ho ga ğŸ˜ğŸ˜‚	Neutral	0.0
oh... apke tu dil mein bhi cracks aa gai hain	Neutral	0.0
Oho apke ghr ke pas wah wah	Neutral	0.0
Apke ankho ka jam ğŸ¥º	Neutral	0.0
Lahore lore he i am also fan of qualander but m n smjha apke itne follower hen paid promotion kr rhye	Neutral	0.0
Kya mai apke tweets par ata hun? ğŸ¥ºğŸ˜”	Neutral	0.0
AchağŸ˜ƒğŸ˜ƒ.....to ma apke sath jyada shear krugi....ma to kehti hu sara ap hi le lo mera lectureğŸ˜œğŸ˜œğŸ˜	Neutral	0.0
order pe banwata hun apke liye	Neutral	0.0
Bahut bahut mubarkbad apko....main bahut khush hun apke liye...congratulations once again... #FarmersProtest	Neutral	0.0
Mae aa jao apke pass	Neutral	0.0
RT : ğŸ˜‚ğŸ˜‚ Aapne le li apni dose Aur apke pariwaar ne, Agar hai to ğŸ˜‚ğŸ˜‚	Neutral	0.0
comments meto sare apke khilaf hen phir ue supporter kon hen jo nzr nahi arheğŸ˜‚	Neutral	0.0
Ap Lahore ko support kro wo apke qareeb prtağŸ˜…	Neutral	0.0
plz khuda ka wasta is ki maan lo ek bar Hath jorte hain apke ageğŸ™ğŸ™ğŸ™	Neutral	0.0
Zindagi me chahe kch b hojaye kisi se apki bne ya na bne lkn kbi apke lye uthne wale hath ni rukne chaiye ye bht zarf ki bt hoti ha kisi k lye b!	Neutral	0.0
Duwaia apke.., Bus kam ma busy ...ğŸ™	Neutral	0.0
Mazy Hain apke tohğŸ˜“	Neutral	0.0
Han mere liye v krna dua mn v kru gi apke liye	Neutral	0.0
Bilkul sath ha sir apke ... apko hamara sahara ha ... aur hame apka . Sahara haa	Neutral	0.0
Ye scheme apke liye ni h ğŸ˜†	Neutral	0.0
Khair h apke hathu muramat ho jaye to vesy b to kch wqt bad to honi h gareeb kiğŸ˜¤ğŸ˜¤	Neutral	0.0
six mar diya gayle ne apke tweet ke bad	Neutral	0.0
Jo pakistani culture ko represent krta ha uske lhilaaf maheen trend chalaya ha apke jese hi logon na. ğŸ˜‚ğŸ˜‚ğŸ˜‚. Ajeeb dual standards	Neutral	0.0
Apke sath Awaam ne hand kr dia h,, Why still in denial?	Neutral	0.0
Sir ap kal apne farm pe gye theğŸ˜ƒğŸ˜ƒ..... enjoy kiya ğŸ¤—ğŸ¤—mza aya hoga ......kaise ha wha apke friends ğŸ˜ğŸ˜......	Neutral	0.0
"RT : Someone please tell me jab sab apke liye ""happy birthday"" ga rahe hon to kaisy react krna chaiye?ğŸ˜­ğŸ˜‚ğŸ¤²ğŸ»"	Neutral	0.0
and it's an eye opener for you Group level per situation apke favour mein ni inflation and unemployment bad governce is at its peak It's time to change your narrative and take action instead of notices and committee.	Neutral	0.0
Well agar apke dost dramy baaz nai to wo dost hi nai ğŸ˜‚	Neutral	0.0
Dil lga kr ghalti ni hoti wo bhi Ap s apke sungdil ko rahim dil krlen gy ik den hum!!!!!!!	Neutral	0.0
Iska mtlb hai me apke raste me a raha hu ?ğŸ˜‚	Neutral	0.0
aur mne to mzaq mn apke sath dia tha :(	Neutral	0.0
Apke* Yar ye autocorrect ne mera dimagh khrab kar dena ğŸ¤¦â€â™‚ï¸	Neutral	0.0
Sir apke account ki dp pe hai apki picğŸ˜‚ğŸ˜‚ğŸ˜‚ #VoteForRubinaDilaik	Neutral	0.0
Kuch pta hi ni apke barey mağŸŒš	Neutral	0.0
Sir din prti din apke face ka glow badta hi ja rha ha kya bat hağŸ˜ğŸ˜ğŸ˜....kya raj hağŸ˜‹ğŸ˜‹..... hmse dur hoke nikhar bad gyağŸ˜§ğŸ˜§ğŸ˜§	Neutral	0.0
Aunty: Beta tumhe kbhi parhtay hue nhi dkha phr b tum pass kesay ho gay? Me: Aunty apke b 3 bachay hain mei ne kuch kha	Neutral	0.0
Apke liay b aik special seat hy. Aa jain agr interested hen to.	Neutral	0.0
Meri jaan apke liye he tou kiya tweet ğŸ˜Œ	Neutral	0.0
Apke pass Waseem bhai ka WhatsApp number ha kia???	Neutral	0.0
Room mei Parents Or muh par pimples kabhi bhi aa sktay hain...	Neutral	0.0
"Heart Emoji bhi lagao sath please dear ""â¤ï¸"" ğŸ‘ˆğŸ» iss tarha ğŸŒ (3)"	Neutral	0.0
Lahore me bhi acha nahi lagay ga. Zalmi/Karachi best.	Neutral	0.0
Kami ko bhi Lahore me hona chahye tha phir.	Neutral	0.0
RT : Ye match bhi Lahore he jeetay ga Inshallah	Neutral	0.0
Mtlb like aise bhi horağŸ‘ï¸	Neutral	0.0
RT : I need unlimited Ameens for ALLAH larkiyon k sath sath sab larkon k bhi naseeb achy kary. ğŸ’œ	Neutral	0.0
aise choday bas timeline pe dekhte hain cricket ki baat ho rahi hai to chalo hum bhi kuch tweet krdete hain	Neutral	0.0
MPAs kaa jo Group hai.... Leader of opposition kaa... Ussmain bhi kisi MPA na send kii hui thi...ğŸ˜…ğŸ˜	Neutral	0.0
han us page se he jaan pehchan hui thi us se. mere dost ka page tha mein Ali or bhi 2 3 dost hum sab wahan admins thay ye tab ayi thi hamein laga larki hai bohat izzat dete thay. ğŸ˜‚ğŸ˜‚	Neutral	0.0
RT : #Shehnaazgill ki latest post pe 20k comments bhi nhi hue ğŸ‘‰ğŸ™kyu kaha ho aap sab #shehnaazians .......... BTW (Soon 3â€¦	Neutral	0.0
Ye raaz bhi us ke sath chala gaya	Neutral	0.0
ye konsa cerelac hai jo sab ko khilana aur khatam bhi nahi hota.	Neutral	0.0
hum apni imagintions mai hotay hay haar waqat hum toh unsay 6 baar milly bhi huay hay khabon maiğŸ˜”ğŸ’œ	Neutral	0.0
han us me bhi tun logon jesi adatein thi. ğŸ˜‚	Neutral	0.0
WB ke karan baki states ko bhi wait karna padega results ke liye	Neutral	0.0
Ho bhi saktey	Neutral	0.0
Koi ni rao sahiba ye defend bhi ho jaye ga in sha Allah fikr na kren	Neutral	0.0
Old Account h shayd mera bhi asy hwa hwa	Neutral	0.0
Koi nahi theek hojaye ga Mil jaye gey dost yehan bhi	Neutral	0.0
Beta tu dekhi 85% bhi Cross hogi ğŸ˜”ğŸ˜	Neutral	0.0
Aj bhi dekhy gy again bhi dekh lay gy ğŸ˜‚	Neutral	0.0
Ary tum to roty huay aur bhi cute lagti ho	Neutral	0.0
Lo ji ispy bhi nakhry ğŸ¤§ğŸ˜‚	Neutral	0.0
Na na ap logo na Kro again bhi ap ko hary gy ğŸ˜‚	Neutral	0.0
Pass to ho hi jaon ga matric me bhi 92% aa hi gyi thi ğŸ¤§	Neutral	0.0
Larai k liye. Team ma ik adha mota banda bhi hona chaiye.. roub acha prta hağŸ¤£ğŸ¤£ğŸ¤£	Neutral	0.0
Dekha ho gia na wiese bhi out	Neutral	0.0
Jb khna bnany ka dil na hua .. inhi ko chbany ka plan bhi hy	Neutral	0.0
Jiska bhi nam lon out hojata hai	Neutral	0.0
Makafat e amal bhi isi dunia main hota hai.	Neutral	0.0
Chaaye banao mery bhi	Neutral	0.0
150 bhi mushkil ha abğŸ˜¡ #LQvMS	Neutral	0.0
lekin phir bhi jeet jayen ge.	Neutral	0.0
Lahore ki bowling bhi farigh hai.	Neutral	0.0
Faheem bhi karlo add.	Neutral	0.0
RT : No one: Le me at night: Checking notifications again nd again.... wo bhi fzool mağŸ™‚	Neutral	0.0
Ary Yar Chase Hoo Jayga aram se Vince Form men hai Sohaib bhi	Neutral	0.0
ğŸ™ğŸ™itna jyada sir... rest bhi karte ho ya sirf kam kam kam kamğŸ˜’ğŸ˜£ğŸ¤”ğŸ¤”ğŸ¤”	Neutral	0.0
Yes but Mola ki Talimaat p mujhy bhi koshish krni chahiye or sbko Hum sb Abhi tk us rasty p ni chl rhy	Neutral	0.0
ğŸ¶ğŸ¶ğŸ¹Kuch nhi kuch bhi to nhi ğŸµğŸµ	Neutral	0.0
Jeety ga phr bhi multan ğŸ˜‚	Neutral	0.0
nahi 2013-14 me bhi aisi form lagi thi iski. SL series in UAE where he scored 3 100s in 5 matches	Neutral	0.0
RT : Sohail Akhtar ki zindagi ka maqsad usay bhi pata nahi hoga.	Neutral	0.0
Camera Kr diya karo Girls k bagyer bhi Kisi tarffff #LQvMS	Neutral	0.0
I meam usse bhi pehly wese galaxy ke customs ma xD	Neutral	0.0
Mera ulta hai papa bolege beta jo diya hai woh bhi wapic leluga ğŸ˜‘	Neutral	0.0
Han yaar itne bewkuff ladkiyan bhi hoti hai kya pagal ğŸ¤¦	Neutral	0.0
Jeet k bad chai bhi pilayenge apko abhi	Neutral	0.0
Dono teams apni hn, smjh nai aa rha support kisy krna hai. Boundary pe b khushi ho rhi, out pe bhi, ajeeb! ğŸ‘€	Neutral	0.0
Khair Mubarikâ¤ï¸ apko bhi Mubarak ho	Neutral	0.0
Wahhhh udhar kal bhi snowfall ho rhi thi. I hope you have funğŸ’•	Neutral	0.0
RT : Inki bhi enquiry karwao kiske pressure me yeh tweets kiye	Neutral	0.0
wo dikhan chahte hain k m bhi tissu istmal krta hn	Neutral	0.0
Good afternoon jummah Mubarak 2 and noi me koi bhi status ya fleet nai lagata ğŸ˜‚ unless itâ€™s important	Neutral	0.0
Shadi to meri bhi nhi huwi	Neutral	0.0
Aur raat k andhere mai 300 body count karny walon ko bhi award milna chaiyeeeğŸ¤£	Neutral	0.0
i iz wese bhi sad now :(	Neutral	0.0
Hota hai mai nay bhi Her likh diya tha ik bar ğŸ˜…	Neutral	0.0
Joo chipkooo lrkyy hotyy naa attitude bhi unhi ko dikhayaa jaataa... Keep in mindğŸ˜ğŸ˜	Neutral	0.0
Ricky Ponting bhi aa gya Qalandars main ğŸ˜³ #LQvMS	Neutral	0.0
6 months used 6 month warranty rehti box bhi hai aur sab siraf game kay liyay use kiya	Neutral	0.0
Jhin ko ghar main koi nahi puchta wo bhi Twitter par attention mang raha hain	Neutral	0.0
Sir pmc ka notice lein Private medical colleges donation le rhe hain or pmc kuch bhi nhi kar rhi	Neutral	0.0
me ne bhi parson yhi kia ha... maro mujhe maro :( ğŸ’”ğŸ˜­ğŸ˜­ğŸ˜­ğŸ˜­	Neutral	0.0
Busy Bhi HUNNNN Match Bhi Haiiiiii #LQvMS	Neutral	0.0
Kham khah ki hype . Us jesi bht han or bhi	Neutral	0.0
mujhy bhi bs aik bar kisi ny dia tha...	Neutral	0.0
Lahore Walo Toss Haar Gaye Ho ğŸ˜‚ğŸ˜‚ Ap logo ky sath sath me bhi smj gya hn. ğŸ˜­ğŸ˜­ğŸ˜­ğŸ˜­ğŸ˜­ #LQvMS	Neutral	0.0
Jab bhi match dekhny ka Dil ho to on kro #jazznet Aur net chalta hi nai	Neutral	0.0
Koi baat Ye bhi hona chahiyee Wo mere aik baba g hain Kehty hain bacheyaan nu istri krde reya kro ğŸ˜‚ğŸ˜‚ğŸ˜‚ğŸ˜‚ğŸ˜‚ğŸ˜‚	Neutral	0.0
Ameen Allah har baity ka naseeb bhi acha kre ğŸ¥°ğŸ¥°ğŸ¥°ğŸ¥°	Neutral	0.0
baration ko dhoop se bachanay ka bhi intizam kar rakha hay	Neutral	0.0
Ameen sumameen JazakAllah khair ap bhi salamat rahen abaad o shaad rahen!	Neutral	0.0
Bro is baar mera bhi batch m 1st roll no hai ğŸ™‚is m positive cheez ye hai k internal se jaldi free ho jayein ga ğŸ˜Œ	Neutral	0.0
Lahore ki Performence ki tarahhhhğŸ˜•ğŸ˜	Neutral	0.0
Ni Bhai Choti honi chahiye thee. Jb apki Bandi ki height chotti ho to aisi khawahish aati ha Dil meinğŸ˜‚ğŸ˜‚â¤ï¸	Neutral	0.0
Yaar hm jeet jayan gai ğŸ¥³ğŸ¥³Rizwan ki bating bata rahi hai.. M	Neutral	0.0
Rizwan ki fifty ğŸ”¥â¤ï¸ He's legend Multan ki Shan hağŸ’ªâ¤ï¸ #LQvMS	Neutral	0.0
Tmny dhndhli nahi ki to jany do adalt tak dodh ka dodh pani ka pani ho!!	Neutral	0.0
Never let your bruh to leave your home while you are going somewhere and he said give me just 15 mints... Allah ki ksm 1 ghente se 15 mint pore nahi hweğŸ™„ğŸ˜¬	Neutral	0.0
Haye sachi ap youtube py Start karo roasting Or ap ki roasting mara favorite part h twitter ka	Neutral	0.0
Ahoo ğŸ¤£ Ik side ki sunn ky mzza ni ata porağŸ˜‚	Neutral	0.0
Guys speed has decreased please don't yrr itni mehnat ki let's do it na Retweet , there many tweets which are not getting retweets including mu! Please please retweets all of tweets with the tag line WE ADORE ABHINAV	Neutral	0.0
Uncle ki fitness ğŸ‘ŒğŸ»	Neutral	0.0
There are still millions living in the villages having no access to cable but they love cricket ko PTV NEWS KI JAGAH pe dikhaya jaata tha But is saal ni dikhaya ja raha must do it!	Neutral	0.0
Tm to baat na hi kro bewafai ki, mahiny pehle kaha tha k details btaogi ğŸ¤¬ğŸ˜¡	Neutral	0.0
10 rupay ki pepsi irtazaa bro sexiii	Neutral	0.0
so on.... Jab sub teachers pst se promote ho kar agay aaen gay tu aik tu teachers ki promotion ka mechanism theek ho ga 2sra har teacher ko pst ki mushkalat aur kaam ki noyyat ka bakhobi andaza ho ga...	Neutral	0.0
Bas Rile khara hai Lahore ki jeet ke beech mein.	Neutral	0.0
Kuch ni Bhai tweets comments wali batoon ki bat kr rha mğŸ˜¬	Neutral	0.0
RT : ğŸ¤©âœ¨Sohni kudi ğŸ˜š ki latest post pe ğŸ˜Œ Bhut saara pyaar ğŸ’« barsaaooo sabbb ğŸ“Œ #ShehnaazGill #Shehnaazians	Neutral	0.0
Yar english me likho mujhe thumhari hundi ki translate kr ke jawab dena prta he	Neutral	0.0
apko b aa jaye gi jald ki insta ki request DM mein	Neutral	0.0
Chalo dekh lyte hain. Kis ki team haarte hağŸ˜…	Neutral	0.0
lala ki waja sy ap MS Waly ho na?	Neutral	0.0
InshAllah jeet Multan ki ho giğŸ˜ğŸ˜Œ	Neutral	0.0
Hazoor (S A W W) ny tijarat ki Hazrat Khadija RA ny tijarat ki Hazrat Abu Bakr RA ny tijarat ki And tijarat is purest form of capitalism. Hence, I have to be pro capitalism.	Neutral	0.0
Koi mjhse match ki baat nhi kre mei exist hi nhi krti. Shab bakhair	Neutral	0.0
HAn Je In Ki Team Fakhar OR HaFEEZ pR dEPEND kRTI hai	Neutral	0.0
Mere ko abhi sirf eye ki pari he	Neutral	0.0
Jis trha se ap ny spelling check ki h ap ny mere feeling ni smjhiğŸ˜’ğŸ˜’ğŸ˜’	Neutral	0.0
Ms ki bat na kia kren	Neutral	0.0
Shukar hai uske over khtam hone k bd tweet ki..	Neutral	0.0
Shart toh aaj lagi meri kal ki phir dekhy gyğŸ˜’	Neutral	0.0
ap ka aik hi dawa hai, hakumat gai wo gai, nuksan hua nuksan ho ga, us ko imran khan bolty hain, ap ki koi b prediction abi tak sach sabit ni hui	Neutral	0.0
Hafeez Ki 50 ki vedio bhj do	Neutral	0.0
Aa giye na wapis match meinğŸ’ªâœŒï¸ Sultans â¤ï¸ Ab baari ha janoobi punjab ki ğŸ˜ #LQvMS	Neutral	0.0
Zainab bhn Multan ki tarf lagti hağŸ˜’ğŸ˜’ Interview khtm hi ni kr rai #LQvMS	Neutral	0.0
Idhr time waste krny ki bjaye chup krky apna prhoo... nhi tuu 40 din phr chand py hi gzurny	Neutral	0.0
RT : Mujhy tou wese hi personal reasons ki wajah se lala buhat Pasand Hain.	Neutral	0.0
uncle ki tabiyat kesi h ab?	Neutral	0.0
Jani aj ni . Bilkul chup. Lahore walo ki tareef kro ğŸ™„	Neutral	0.0
ky apko sb kuch apni mrzi or time pr mila tu iska mtlb yeh nhi ky Allah ksi ko dair se nh deta .Allah ki mrzi ksi ko jaldi dy or kisi ko late .Ap kon hty puchny wly .	Neutral	0.0
Jo meri kismat ka hai wo mujy mil hi jay ga Jb Allah ki mrzi hogi .Or Allah sbko sb kuch deta hai ksi ko jaldi kisi ko late .Irritation us wkt hoti Jb hmse zda logo ki fikr hti ky tm abi tk jobless ku ? single ku ? khubsurat ku nhi ? weight ku zda ? Mera dil krta ky puchu	Neutral	0.0
Ab humain coffee ki tyar rkhni chahhy	Neutral	0.0
Aaj kis kis na eid ki namaz parhi..??? #13Rajab	Neutral	0.0
Yha thory din ki takleef hai .guzr jy gy yeh din .Tum Kisi ky sath zulm nh krna bs .Mout bht asan hogi .	Neutral	0.0
Phir lhr ki haar rukni ni aaj hum start kare ge harana	Neutral	0.0
Ye bnda is bndi ki tweets fav krta rehta hy, or wesy kbhi isko ye zehar lgti thi..	Neutral	0.0
Yarr bus kro Amir sohail ko commentary ki	Neutral	0.0
LHR KI HO RHI YAH KR RHY?	Neutral	0.0
Youhi ni hoti tareef lahore ki Yay jo zmanah ki heer ha lahore hi ki to hağŸ˜œ	Neutral	0.0
7 subjects hain ek sth hai paper 4 hours ka ya btao tum konsi filed ki ho	Neutral	0.0
Yr everything ki to smjh a gai . Lekin nothing wala kya scene hai?	Neutral	0.0
Perfume Mai Choice Kis ki Best Hoti Hai?ğŸ¤” Boys Ki? Girks Ki?	Neutral	0.0
Ab mn kia bolon ğŸ˜‚ğŸ˜‚ğŸ˜‚ chussain marty rehty hn log bs ğŸ˜‚ğŸ˜‚ğŸ˜‚	Neutral	0.0
Post ki smjh ni lgi ?	Neutral	0.0
ye to pata ni kb se hurt ho rha tweets ab ki hain	Neutral	0.0
RT : Duniya ki zindagi aarzi ha..Bus Allah k btaye ehkaamat par amal kar k he kamyabi yaqeeni ha InshaAllah	Neutral	0.0
Khaali ho gaye hain kaafi saary ..sab teachers city areas ki taraf transfers karwana chahty hain	Neutral	0.0
Chotty bachon wali baatain kiia kro abhi umer nahi ha pyar wayyar ki aapki ğŸ˜ŠğŸ˜Š	Neutral	0.0
ye dekhein har lamha purjosh ki 1st episode m apky change hair style ko kitna psnd kiya gya ğŸ˜ğŸ˜ğŸ˜ sch kahun to mjy b BHT acha lga change hair styleğŸ˜ŠğŸ˜Š MashAllah bhht pyaary lg rhy aapâ¤ï¸â¤ï¸ abhi dkhi meiny ye episode...	Neutral	0.0
ğŸ˜‚ğŸ˜‚nii hun m biryani ki But mjh p sohn hlwa ban ni krwao ğŸ˜‚multn s niklwao guy kia	Neutral	0.0
Han haar ki tyari abhi se kar reh good	Neutral	0.0
RT : Crush ki black kurta me snaps ğŸ¥µâ¤ &gt;&gt;&gt;	Neutral	0.0
"Wo gaana hai na ""My name is Sheelah sheela ki jwaani"" wo wali"	Neutral	0.0
Hayeeee ğŸ¤•Meri Usy Purpose Krny Ki Khawahish Puri Na Ho SakiğŸ˜•â˜¹	Neutral	0.0
Banaya jo nai tu likhna diya ğŸ˜‚. Meri shkal dekho ksi ne frndship offer b na ki mujhy tu	Neutral	0.0
Ksi ko reply rahny b dia kro bhaiğŸ˜‚	Neutral	0.0
Nii janu mei khn busyğŸ¥ºu b tu ni krti naw bt	Neutral	0.0
yeh simple si bat logoon ko samj kyn ni a rahi	Neutral	0.0
OohğŸ˜®ğŸ˜®main nazar ni ara kyağŸ˜‚	Neutral	0.0
Me fit bt b ni krti tuğŸ¥º	Neutral	0.0
Hona to alag baat ha. Inho ny krna hi ni ha jis trha ye bowl se dar rhe hanğŸ™„	Neutral	0.0
Lahories be like: Ik match haar bhi jana chaiye. Ami khti hain is trha nazr ni lgtiğŸ’#LQvMS	Neutral	0.0
Keke koi ni Mera pass kafi time ğŸ¤£	Neutral	0.0
Aj to mood main niğŸ˜¦ğŸ˜¦	Neutral	0.0
Aj niğŸ˜‚ Karachi Waly match ka wait karo abiğŸ˜œ	Neutral	0.0
Rooz rooz eid ni hoti sirğŸ˜‚ğŸ˜‚	Neutral	0.0
Jb tk ap treat ni dayn gee tb tak	Neutral	0.0
Main ta unfollow krn vale chotte kmm ni krdi ğŸ˜Œ Sidha block kridağŸ˜	Neutral	0.0
App ni hai yeh. Jaaz Cricket app py laga hua hai match. Aur mai google py dekhra	Neutral	0.0
Tm biryani khany yha ni aa skti? ğŸ˜­ğŸ˜­	Neutral	0.0
Hahahah hmain to hilne hi ni dia thağŸ¤£ğŸ¤£ğŸ¤£	Neutral	0.0
Aik adhi e giri gi zayada ni	Neutral	0.0
meri shadi kr rhy hain is mulk sy bahir aur mein jana ni chahti. tm krlo meri jagah	Neutral	0.0
Aysy e hota hr lrki khush kismat ni hoti	Neutral	0.0
When people say's koi problem ho to mujhyâš¡ bta dainaw but my msg seen ni kro Ga/Kro Gi is silent ğŸ–¤ğŸ˜	Neutral	0.0
Parh lennnn C aa jana ni to	Neutral	0.0
Dekha kuch bhi ni hai ğŸ˜•	Neutral	0.0
Ni phr Ap ny unhein walimy pe nii dekha hoga ğŸ˜ğŸ˜‚	Neutral	0.0
ğŸ¥² jinka koi friend ni hta wo games hi khelty hn ğŸ™ƒğŸ’”	Neutral	0.0
Shadi se Pahle jis Room main Bagair kundi k so sakte the ab Bagair kundi k ni So sakteğŸ™‚	Neutral	0.0
India pakistan ky sath dosti srf timely frienship kr sakta.. Permanent ni ar definitely koi back interest ho ga ğŸ¤”	Neutral	0.0
Bhai tjhe Jwab ni mille Ga to Ni haiğŸ˜‚	Neutral	0.0
Yah to bimar ni tha	Neutral	0.0
Han to dosti ka lia bola to ha bat krai apni larki sa ni to phir ma bi larki ho attitude a jai ga muj ma bi..	Neutral	0.0
Mujhay Asi chezzain hazam ni hoti .ğŸ™„ğŸ˜…	Neutral	0.0
Itna sar dard tou proff k dino mein ni hoa jitna ab ho rahağŸ¤¡	Neutral	0.0
Tumhy yahan ni mily gy. Africa jana pary ga	Neutral	0.0
Jb pure ka pura Pakistan khane wale dakar bh na lein wo zinda ho skte hein to yai kyu ni?	Neutral	0.0
But sorry mrey pass ha pri , ap ke lya time ni ğŸ˜‚ğŸ˜‚ğŸ˜‚ğŸ˜‚ğŸ˜‚ğŸ˜‚	Neutral	0.0
Qabar ye ni dekhti kon aa raha ha Qabar ye dakhti hai ky kon kia laa raha hai...	Neutral	0.0
Kahin ap salmon bhai k fan to ni?	Neutral	0.0
Sindhi ni ati	Neutral	0.0
Wide awake. Aur munh chal raha. Khana band ni hota re baba ğŸ˜‚	Neutral	0.0
Header Ni dekha To kuch ni dekha JaniğŸ¥€â¤ï¸	Neutral	0.0
mera ptcl hai yeh kabhi fast ni huwa to twittr hi down hogağŸ˜‚ğŸ˜‚ğŸ™‚	Neutral	0.0
Na songs sunne ka dil ni kar raha	Neutral	0.0
Itni hony k baad bnda tweet bhi dlt kr deta hai lkn lgta hai noorani shb ko koi frk ni pra.......... ğŸ¤£	Neutral	0.0
Hahah belkul sai kaha ma khud ni otaa koi bhii he band ker deta ha ğŸ˜œğŸ¤£	Neutral	0.0
Khair koi ni wo b to bichara insan hi ha na. Koi ni chaly ha kro campair â™¥ï¸â™¥ï¸â™¥ï¸â™¥ï¸â™¥ï¸	Neutral	0.0
Wese e puch raha hu teri yadasht theek ha ke niğŸ˜‚ğŸ˜‚ğŸ˜‚	Neutral	0.0
Yahan salan ni hai mein jam sy kha rha hn :/ dil khrb horha hai	Neutral	0.0
Dusky ko to humara khyal hi ni ğŸ™‚ğŸ’” Mei bs bna rha tumhare sath	Neutral	0.0
N yar wo the person r bestie ka ni tha just mazak m create KIA husband wife r Falaa falaa in sub n to pakr hi lia	Neutral	0.0
She definitely knows k ao jag ri o.... Pr wo pretend krti hain k unko ni pta ta k apka bhrm reh jae Maan Maan hi hti he â™¥ï¸ğŸŒº	Neutral	0.0
Me islami aur achi tweets ko likes krta hun Ghair islami aur ghlt tweets ko like ni krta Alhumdolillah	Neutral	0.0
Wese sach mei meri to koi bestie hai hi ni yahan ğŸ˜”	Neutral	0.0
Ni tum api e bola kro finally koi mjh sy b chota h yhnğŸ˜	Neutral	0.0
Ajj poetry ka mood niğŸ˜¬	Neutral	0.0
Shadi k liye b Chanda akatha krna... Aj jumerat guzar gaya. Itna ni hua k 4 seats le sken... Kindly adjust :-)	Neutral	0.0
Hansne ki bat ni ye actual mei hi meri bhn hai ğŸ˜’ğŸ˜‚	Neutral	0.0
Yesh idr koi ni ata yar 1100fallwors hain jis ma sa koi ata ha koi ni kia waja ho giğŸ˜‚ğŸ˜‚ğŸ˜‚ğŸ˜‚	Neutral	0.0
Ni 1 hi glti bar bar nh karty	Neutral	0.0
Tu wese ignore hone wali cheez ni mujhe e tu chup karati raha kar har dafağŸ‘ŠğŸ˜‚ğŸ¤¦	Neutral	0.0
Bhai faida ka name ni or na mtlb ka	Neutral	0.0
Streks ni send ke aaj	Neutral	0.0
Na bazu fold karta na watch pehnta aur beard itni bari aa ni rahiğŸ˜‚ğŸ¤¦	Neutral	0.0
Sapphire kbhii mjhyy to ni btayaa tu nyy???? ğŸ™„ğŸ™„ğŸ™„	Neutral	0.0
Hum bechary yhi keh sakty hain Aur koi option jo ni hai	Neutral	0.0
Honestly i feel a bit sorry for asim azhar as well, I mean okay he shouldnâ€™t have made fun or said anything at this point lekin phir bhi the loss was all his. He lost so many friends and fame, and hania lost nothing so yeah the frustration is understandable. #AsimAzhar	Neutral	0.0
Shayar bhi hota tou tere Dil pe dewan likhta	Neutral	0.0
Sab Bolte hai Waqt ke saath saath sab thik hojata hai Lekin Kabhi kabhi waqat ke saath sab theek nahi khatam bhi ho jata hai.â€ğŸ˜¥ğŸ˜¥	Neutral	0.0
Talent soye hua bhi kr leti hun	Neutral	0.0
RT : Can someone file a petition to re-open the case. Judge sahab ko uski video bhi dikhana ğŸ˜’	Neutral	0.0
tasveeron mein muskurahat thi ab mere chehre pe hai kyun nahi ye poochte in gairon ko hai samajh nahi koi tasveeron mein tum bhi khade the	Neutral	0.0
Inki to utilisation bhi alag hi hoti h bhai sahi h kro utilise apna time lekin dusro ko matt sikhao ki kya krna h aur kya nhi.. NOT GUILTY UNLESS PROVEN #JUSTICEFORPEARL	Neutral	0.0
when Atif said â€œmilke bhi hum na mile tum se na jaane kyunâ€ i felt it	Neutral	0.0
Pata chaly tou mujhy bhi batadenağŸ¥²	Neutral	0.0
ğŸ¤›ğŸ» Soo jao kal camera on karke professor se bhi toh baate karni hai aapne	Neutral	0.0
Aap itna motivation karte ho to aap bhi sabko motivate karo ground pe aane k liye.. hume sab chizo k liye sabko motivate karna hai	Neutral	0.0
idk why I think..wait.. is it only for kpop groups and artists ya koi bhi ?	Neutral	0.0
Ye bhi saab foreign tourists k behalf py apny dil ki bat kar rahy hnğŸ˜	Neutral	0.0
Vaccine jo bhi mil rahi hai kagwa lein. Parents ko toh yaqeeni lagwayen. Bohat zaroori hai. Aur main bhi issi week lagwaon gi!!! Mera code nahi aaya hua tha	Neutral	0.0
Mujhse bhi sekh lo	Neutral	0.0
Agar Sahi bhi h to tumko kya ajnabii ğŸ˜¹ğŸ˜¹	Neutral	0.0
Is garmi ma bhi hm chaye peety hain ğŸ¥´	Neutral	0.0
Tere dimag me puns ke alava bhi kuch chlta h?	Neutral	0.0
RT : â€œItna tu kisi ne chaha bhi na hoga, Jitna main ne sirf soocha hay tujhey.â€	Neutral	0.0
Mjhe to tum bhi online wale hi lg rhe ho	Neutral	0.0
Us jesa phir bhi koi nahi hai ğŸ‘	Neutral	0.0
Jisky dil mai hussain(as) rehta hai... Farsh majlis ka jo bichata hai... Jo bhi noha kaahi sunata hai. Leky naam hussain(as) rota hai. Usko zahra(sa) salam krti hai... #NadeemSarwarLivingLegend	Neutral	0.0
Chota handle hone Ka bhi alag hi dukh hai ğŸ¤§	Neutral	0.0
Mizfar soo ja kal uni bhi janaa he ğŸ˜‘	Neutral	0.0
kesa czn he shakal bhi nhi dikhai	Neutral	0.0
Gily krny wala bhi koi nai	Neutral	0.0
It will never reach those heights. Even though mujhe bhi yeh Karna hai	Neutral	0.0
Agr love km bhi ho jaye Kbhi bdlna mt khud ko	Neutral	0.0
Lol tou sachayi pata chalne ke baad kyun shadi karegi koi bhi larki?? Be rational	Neutral	0.0
Mere bhi yaar; who knew we could get so used to a pandemic lmao	Neutral	0.0
Haste logo ko BHI bikharte waqat nhi Lagta ğŸ’”ğŸ¥º	Neutral	0.0
Btw the more outfits thing exists idhar bhi xd. They're just less expensive compared to women's clothing	Neutral	0.0
Jaadu ka jahaz bhi inhone chalaya hoga	Neutral	0.0
tujhe bhi koi difficulty ho toh just consult me	Neutral	0.0
Acha.....mare dost bhi naraz ha ğŸ˜” Kia kya ha apna?ğŸ™	Neutral	0.0
You know ab bss ho gai ha Koi bhi nai ha jo pyar sy galay laga k kahay k tension nai lo sb thek ho jaye ga ğŸ™‚	Neutral	0.0
Me to weather: Hey!! Tuje bhi mood swings ya weather swings hote hai kya aajkal?ğŸ˜‚ğŸ˜‚ #weatherswings	Neutral	0.0
Ye reserch ka result btane wali bhi ladki rhi hogi.. Sbne believe kr liya.. ğŸ˜‘ğŸ˜³	Neutral	0.0
Mein bhi yehi sochta houn roz bas phir idk, you get it na?	Neutral	0.0
ye lo tum bhi peelo thak gayi hogi logon ko pani pila ke	Neutral	0.0
RT : Mujhe sabse zyada koi janta hai samajta hai even daat ta bhi hai to woh tu hai... hamari friendship pata nhi kaise ho gaâ€¦	Neutral	0.0
Uss Shareef mohtarma ko gaaliya ati bhi hai pochna tha uss sağŸ˜‚	Neutral	0.0
Aasa hy Pakistan main bhi aisa hojaye ğŸ˜€	Neutral	0.0
500 itne azeez the to humein bta dete hum gofundme chala dete, itni bhi kya majboori thi	Neutral	0.0
Meri laakh buraiyon ko Jaante huwe bhi, Mujhse muhabbat karne wala Sirf mera khuda hai.â¤ï¸	Neutral	0.0
But baad mein bahut logon ne acha bhi likha... and ignore karne bola kuch ko ğŸ’–	Neutral	0.0
uni ab kisi waqt bhi khul sakti hy ğŸ¥º	Neutral	0.0
idkğŸ˜­ğŸ˜­i read it somewhere waie bhi iâ€™m not very into signs and all	Neutral	0.0
Most probably yes, ab ultimate decission kya hoga, yeh hum bole bhi toh bole kaise. Lets try all that it takes.	Neutral	0.0
Mushkilein meri zindagi mein bohat ayi, dhokay diye maine thokrein bhi bohat khayi.	Neutral	0.0
Yes... But kuch bhi ni ho rha....	Neutral	0.0
Dil ka abhi bhi hağŸ¥ºğŸ’“ or header temporary ha osko choroğŸ™‚	Neutral	0.0
haseen bhi zaheen bhiğŸ˜¼	Neutral	0.0
Mujhe sabse zyada koi janta hai samajta hai even daat ta bhi hai to woh tu hai... hamari friendship pata nhi kaise ho gayi par tu mere liye kisi blessing se kam nhi ğŸ¤’mere har acche bure time me mere sath rahi haiğŸ˜‚ bas jaisi hai waisi hi rehna kyuki tu best hai bff	Neutral	0.0
Tm bhi start kro yh game ğŸ˜‚	Neutral	0.0
Phelay wala bhi theek tha wo apko samj nh aya ğŸ˜‚	Neutral	0.0
Hahah ladka chalegi but ladki agar woh banna pada for the hug i dont care kuch bhi ban jaungi	Neutral	0.0
Itne bhi bure din nahi aaye	Neutral	0.0
"RT : Ever since I started thinking ""Allah yahan tak laya hai tou agay bhi wohi lai kar jayega"", my life has become easier."	Neutral	0.0
Noii Tu Sabse pyaari ğŸ¥ºğŸ’˜ Alabu tujhse bhi zyada ğŸ¥ºğŸ˜­ğŸ’˜	Neutral	0.0
Apny mashwry pe khud bhi amal krna seekhein ap	Neutral	0.0
Idhar mai bhi shreef hu ğŸ˜‚	Neutral	0.0
Bus bro my advice is jo bhi distance han ise khatam krk just go for it. Ye bus first time hesitation hai. Bus regret se acha hai abhi ye step lelena chahye. Love him as much as you can. They're the blessing in one's life	Neutral	0.0
Tailor na mery kapry khraab kiyay and mama said: Zroor tum na sahe sa btaya nahe hoga. Tailor na mama k kapry bhi khraab kar dya and she said: Kal ma khud jaon gi is na ya kya bna dya hay. ğŸ¤¦ğŸ»â€â™€ï¸ğŸ¥º	Neutral	0.0
Itni mehnat apna Qaomi tarana yad karny par bhi ki hoti.	Neutral	0.0
Wo mujhe aur bhi pyari lgti hain, Jab wo meri maa ko wo maa keh kar bulati hain.â¤ï¸	Neutral	0.0
Bhai jurmana aur Woh bhi wada	Neutral	0.0
WB kal sy Adil ka school bhi open ho raha hai na??ğŸ˜Is he excited Ya usay ab ghar reh kr Baba ko tang krnay ki adat ho gai haiğŸ˜‰	Neutral	0.0
Muje bhi koi android ki dhoond dooo mkc Ali butt ko dekh kar mar jao ga	Neutral	0.0
Kash mjhy bhi koi kehta shutup you're mine ğŸ™‚	Neutral	0.0
Once a Legend said; Kch bhi dikhaya ja skta hai ğŸ˜‚	Neutral	0.0
Mujhe bht bolne k baad sikhaya hai.. Tu bhi bolti reh.. Tujhe bhi sikha degiğŸŒğŸ¥º	Neutral	0.0
Ni wo khty hn shukr hai jaan choti ab shyd prh bhi ly ga yeğŸ™‚ğŸ¥º	Neutral	0.0
RT : Relax Guy's first day wese bhi koi nhi Ata ğŸŒš	Neutral	0.0
Ayi hogi kisi ko hijar mai mout Hamein tou neend bhi nahi ati.	Neutral	0.0
And i dont knowee...second czn hai mujhy sirfuska name pata hai, ig London rehta hai to meiny shakal bhi nai dekhi wiğŸ¤¡ğŸ¤¡ğŸ¤¡	Neutral	0.0
ğŸ˜‚ğŸ˜‚ğŸ˜‚ap to train sy bhi zayda fast ho BTW thanks i don't know how to react on this ap yeah batao ho kaha sy	Neutral	0.0
Han bhae asim hania ka bhi scene hogaya, bahria ka bhi scene hogaya, sunita marshal ka naik scene bhi hogaya. What's next now? Zombies attacking gulshan and johar? Ya phir godzilla arrives in karachi with heavy snowfall?	Neutral	0.0
"When Talha Anjum said ""Kuch aesi bhi rahain mushkil thin Kuch bat ma gham ka tok bhi tha Kuch sheher k log bhi zalim thy Kuch muja marna ka shoq bhi tha"" I felt that badlyğŸ’”ğŸ™‚"	Neutral	0.0
Waqt ne hai kya hm pe kesa sitam Tum bhi bezaar ho barbaad hn hm ğŸ–¤ğŸ	Neutral	0.0
Give me this guys pls Twitter instagram kuch bhi dedo pls	Neutral	0.0
Tu kuch bhi tweet karta h aur itne saare likes aa jate h ğŸ™‚	Neutral	0.0
RT : Souncha tha bhout toot kar chahage tujhe, Chaha bhi hum ne toote bhi hum	Neutral	0.0
RT : Financial worries really eat you from inside istg your mental health fucks up so badly, Allah Kisi ka bhi rizq na roke	Neutral	0.0
Allah tumhy meri umar bhi laga dain.	Neutral	0.0
RT : Lame excuse .Pura saal school bhi open hote na jinho ne nhi Prhna Woh fail tab bhi hote .ab jao shabashâ€¦	Neutral	0.0
"RT : kiya tumhe bhi koi ""good night"" wish karta hai dailyğŸ˜—ğŸ¤”ğŸ˜‚"	Neutral	0.0
10-15 ladke pakad ke main bhi nach panjaban nach pe video banaunga jaise woh pakistan ke ladko ne banai hai	Neutral	0.0
wo bhi ban jayen ge koi baat nhi	Neutral	0.0
Chhoro.. I donâ€™t care anymore, sab karke dekh liya kuch nahi hota.. Waise bhi chali jayungi	Neutral	0.0
watching peaky blinders phir bhi	Neutral	0.0
Hayeee bht maza arha hai yawrr bht maza arha hai #LQvMS	Neutral	0.0
Sureâ¤ğŸ’Wesy Eysy kaha to Pakistaniyon Ny Her tweet mein mention kr kr kr k Update deni haiğŸ˜‚ğŸ˜‚ğŸ˜‚ğŸ˜‚	Neutral	0.0
Girls after 30 mins in relationship: Babu ainda ap cigarette nahi pio Gay or bike aista chalao Gay apkay andar jaan hai meri baby	Neutral	0.0
yess bas lag raha hai time guzaar raha hai. with Karachi he looked great	Neutral	0.0
"RT : Zindagi Kam â€œparwaz hai junoon"" zada lag rahe hai"	Neutral	0.0
Kya ho gya yaar kyu mood off hai ğŸ˜•	Neutral	0.0
ALLAH ko boht pasand hai jb tum duniya sy nahi us sy Mangty ho.â™¥	Neutral	0.0
Bina Makeup ky Shadi Attend krny ka Confidence Hai kisi mai ?ğŸ™‚â™¥ï¸ğŸ™ŒğŸ»	Neutral	0.0
Kesi jaa rhee hai sb ki life???	Neutral	0.0
Dil se bura lgta hai bhai Pr professor why so serious ?	Neutral	0.0
RT : My abba explaining my doctor what exactly happened to me â€˜iska engine chota hai jaldi garam ho jata haiâ€™ ğŸ¤¡ğŸ¤¡ğŸ¤¡	Neutral	0.0
Haha yaar wahan tabar nai hai banda sakoon say use kartağŸ¤§	Neutral	0.0
Han na duniyaaaaaaa ko pta lgna chahiye k kon hai ye azeem hasti ğŸ˜‚	Neutral	0.0
Maryam to wese hi off hai kisko tag krun ğŸ˜”	Neutral	0.0
Chalain Allah pak ab unko khush rakhain Ameen Ameen ğŸŒ¸ğŸŒ¸	Neutral	0.0
universities bun rehe hain new butt jobs koi nh create kr rhi govt or HEC hik saal ka contract deti ha pahly hr fresh PhD ko wo b ab nhe dy rehe #savePhDs	Neutral	0.0
But i think ab yaii he jis se pta chaly ga 1 dusry ka, friends, classfellows, roz mil to nai sktyyy nağŸ˜”	Neutral	0.0
Han akhri rasta yehi bachta hai abğŸ˜‚ğŸ˜‚ğŸ˜‚ğŸ˜‚	Neutral	0.0
Astagfirullah Dp dekh ke mera tu traa hi nikal gyağŸ˜­	Neutral	0.0
Mera kiyoun mood kharab kr rai hoğŸ˜£ğŸ˜£	Neutral	0.0
RT : HAAAN YE ZIDDD HAI MERIII TUKHKO HI SOCHENGE AB HUM	Neutral	0.0
Ab mujhy yaqeen ho gya k aap ko Islam ka kuch bhi ilm nai jab aap basic rules ko hi follow nai kr rahi hain to aage kia krna he.	Neutral	0.0
Wo to ab bhe hy shehzaday ğŸŒ»â¤ï¸	Neutral	0.0
Main paida honay se ab tak shareef hunğŸ¥º kisi se bbi poch lainğŸ¤§ğŸ¥ºğŸ˜‚	Neutral	0.0
Sitaaron k Jahan me milenge ab yara	Neutral	0.0
ğŸ˜‚ğŸ˜‚ bhayee main kia kron ab?ğŸ˜‚ğŸ˜‚	Neutral	0.0
Sab ko already pta hy...ğŸ˜‚ğŸ˜‚ Fake posting ka koi faida ni hamein asa ab b krna ho ga.ğŸ˜	Neutral	0.0
Multanio khuda ky liye humay mauos na krna kal ana hai ab ny . #cancelExamsSaveStudent	Neutral	0.0
Is hadees ko hum per laazim he k mana jai or dusra ye k ye hadees itni hi he kuch add nai kia gya he ab maloom hua k aap logo kese hamare baare me is tarah ki baat kr k gumrah kia ja raha he. Kuch add nai kiya he	Neutral	0.0
ab jo phly waly Questions hain unka jawab dedy	Neutral	0.0
G Huda. Ab INSANO par to trust naho hota asani sa	Neutral	0.0
Ham sa 2018 mea srf ek jalti hui tee gis ki mar abi tak huma par rhi ha likn youth or students ab pechla bol ka new govt chti ha jo ek ka haq ki baat kra ğŸ™‚ #PMLN zindabad #27junelahoreprotest #cancelExamsSaveStudent #CancelExamsSaveLives #CancelAllExams	Neutral	0.0
Banjar Sa Ho Gya Hoon Mai, Mujh mein Ab Koi Khushi Nahi Ugti ğŸ™‚	Neutral	0.0
Afsoos ki baat he k aap ko kisi ne itna ziada gumrah kr dia k aap ko haqeeqat ka ilm hi nai he. Masla ye he k me ab itni lambi baat yaha per nai likh sakta live baat hoti to me aap ko clear kr deta k asal baat kia he	Neutral	0.0
â˜ºï¸â˜ºï¸â¤ï¸â¤ï¸ Btw aj nahi boli kuch ğŸ˜‚	Neutral	0.0
Okay you are so cute your shirt clr is so nice and the chain is also looking good the angle of ur pic is perfect your hairstyle is boom....ab kaafi hai?ğŸ˜‚	Neutral	0.0
Btta b do koii ab ğŸ¤”ğŸ¤”	Neutral	0.0
jhoti Pakistan tm logu ki hakomt ki wja sy gray list me gia or ab esi batyn zaib nh dti.. social media ki wja sy tum logu k jhot aik scnd me pkry jaty hain..koi shrm hoti h koi haya hti hy	Neutral	0.0
Yaiiii tha subah se yaiii bol ry mjy smj to ab aai ğŸ˜­ Jaaa ri hu meinğŸ˜”ğŸ˜”	Neutral	0.0
Nai me smj gaii uska mtlab tha jao jaan choro abğŸ˜­ğŸ˜­	Neutral	0.0
Hain hain.... M ny tu Pubg k liye rkha howa tha phr Tiktok k liye r ab del kr diya bcz ab zrurat nhi rahi...	Neutral	0.0
Ignorance is best policy b ab kaam nhi a rahi ab gayuğŸ¥ºğŸ¥º	Neutral	0.0
Mjhy murshad mery Mil gy hainâ¤â¤.Bs ab thory paisy a jain kahi syğŸ˜…ğŸ˜…	Neutral	0.0
ab ma tweetr pa wps aa e gya hon ap log lft e ni kra rhy	Neutral	0.0
Aj kal bhi isko koi serious leeta hai? Ya as a comedy dekhte hn isko meri tarah? Ab tu woh bhi nhn dil krta	Neutral	0.0
Anna. Yaar mene na ss itne lie the laikin . Mere se editing hi ni hori thi. Phr mene srf inhi 7to ki lgadi. Inshallah kisi se bnwaogi	Neutral	0.0
RT : Hazuur jou e Transfer k problem hyn ab tbah h rhyy ghrnn k gher ab kuch krnn es July mn	Neutral	0.0
DADI ily 2 bold de ba mat tu ne je ge na ab ğŸ¥ºğŸ’”	Neutral	0.0
Mere liye to na mumkin hy ab	Neutral	0.0
Sir g kuch h log hyn jinkoo br br fyda mil rhaa hyy ... 35 hzar sy 40 hazard bsssss bqi ksii k ni ho rhaa .... Jinkyy pas pysaaa hta unhnn t phlyy b maslaa ni tha na ab hyyy	Neutral	0.0
Sir g plzzz 3 Saal syyy hum pryshan hyn eik femail k sthh 2 khandan juryy htyy hyn. Plzzz reham krnn ab . Es julyy mnn plzzz sir mehrbni frmaen.	Neutral	0.0
Haha ğŸ˜‚ğŸ˜‚ğŸ˜‚ Ab thek hai grr brr to ni hai	Neutral	0.0
Ab ye kis ny kaha khud ki apni bat ko manfi kar deta hai ğŸ¤­	Neutral	0.0
Chalain ab achi bachi banain or mujhy s/o dain ğŸ˜	Neutral	0.0
Mujhy ab besti feel hori he. Me ab reply nai krugi ğŸ™‚	Neutral	0.0
Han mjhe habiba jo mili hağŸ¤¦ğŸ»â€â™€ kia kr skty ab Allah ki mrzi isi main thi ğŸ˜‚	Neutral	0.0
Ab mera chuss level acha hy sir?ğŸ˜¥	Neutral	0.0
Apne dil ki baat bata rhe h.. Ki u r interested in #Exception.. Bas Bind Formation bach rha ab to	Neutral	0.0
Dra sal Maar Es Liye prhti Thi k Meri Class ki larkiyan Kheti Thi Mam Ko k Teacher esy Mary Ye Ab Bigrh rha Hai.ğŸ‘€ğŸ˜‚	Neutral	0.0
Moka acha he dono hisab pora kr loğŸ˜ª, mere toot pe tu aye ni the yh clbğŸ™‚	Neutral	0.0
Follow back ka bol do then ab .. Jasy apka hukmğŸ¥ºğŸ¥º	Neutral	0.0
Mere 996 marks thy pr ab 696 bhi nhi aa sakty	Neutral	0.0
mujhy kia hona....mujhy pehly sy pasand hy abry dino sy whatsapp pr kisi poerty group ko dhond raha tha ab ja k mila hy ..	Neutral	0.0
Allah ki Mohabbat k siwa har Mohabbat ko Zawal hai. Phir wo sab kuch dikha kar aadmi Sy kehta hai - ab bata tera Mere siwa Kaun hai? Shehr e Zaat	Neutral	0.0
ab naye cellphone par haath set honay main time lagay ga. ğŸ¥²	Neutral	0.0
aahh okk or ab ap ne theek h rhna h â™¥ï¸â™¥ï¸	Neutral	0.0
Degree ka hieght sa kya talooqğŸ˜… 9th class ka baad ab tak hifza itni hi huğŸ˜…	Neutral	0.0
Ab bhi karty Rehna chaiy na , Wo Log Daily Routine me Zulam Bardasht Kar rahy hen , hamee Kam az Kam Daily Awaaz raise Karni chaiy , At least hum itnaa to Kar sakty hen na	Neutral	0.0
Nai ab to nazar lag jo lagni thiğŸ˜’	Neutral	0.0
Ab paper ky bad tou bnti ha scrolling ğŸ˜‚ğŸ˜Œ	Neutral	0.0
ab dobara ye mann marzi hum sy nahi hogi aap jesi khud garzi hum se nahi hogi	Neutral	0.0
Full book btai to hai Ab ar kya syllabus chahyeğŸ‘€	Neutral	0.0
Chlo ab kal k final ki tyari kroğŸ¥ºğŸ’”	Neutral	0.0
Kitna hint diya hain ab toh maan jao nağŸ˜‚	Neutral	0.0
Ye to Hy phr ab Kya kare. Kl ugly logon ko kh du gi phr AP krna replyğŸŒšâ™¥ï¸	Neutral	0.0
ALLAH PAK nay ab Dil ko sukoon day dia hai ğŸ˜‡	Neutral	0.0
Phases atte rehte naaa Jo log phle khte the streak bad mein bhejte Dekh phle Lete ,har waqt online rehte ho Ab kehte 2 weeks hogaye hmari streak Nahi kholiğŸ¥´	Neutral	0.0
Bhai jaan english seekhni chahie q k ap pori dunya se touch me rehte hen is trah lkn kisi pe roab jharrne k lie na boli jae	Neutral	0.0
Yr meri sis ko 20 sal se h ab to daily table lena prti h	Neutral	0.0
Oooo ab kiaa ho gaa	Neutral	0.0
Babe dekho ab mein apko kahan kahan mention krta hn	Neutral	0.0
ALLAH Pak ka Bra kram hai Ab btaen kesi hain?	Neutral	0.0
Very good meri batein ab ap ko psnd ane lagi ğŸ˜‚	Neutral	0.0
Ab agar reply na mila to na retweet krum ga aur na like	Neutral	0.0
Tum dono ki zindagi ab poeet main hi guzragi	Neutral	0.0
Bhai 2 sal sy Bilalwal bhutto betha raha daba kr .kitni baar shireen mazari bta chuki discuss e ni hony dy raha tha. Ab ja k pass huwa. Ab implement ho ga	Neutral	0.0
RT : ğŸ¤£ğŸ˜‚Hamare Laye Is Elaan ki koi Importance nhi hai Hum Inshallah Exams Cancel karay gaiâ€¦	Neutral	0.0
Ab to hans skta hn ya nhi?	Neutral	0.0
Mahobbt ho gai thi 2no ko Ik arsa ho gia Mera ye ishq tha do tarfa Ab 1 tarfa ho gia ğŸ’”	Neutral	0.0
bs ab wait hi krty rahen or is baat ko surprise hi rhny denğŸ˜…ğŸ˜ğŸ™Š	Neutral	0.0
I donâ€™t know how other siblings have meaningful whatsapp convos. I msg my sister like â€œ Hiâ€ she replies ab kya masla hai tmhe main koi kam nahi kro giğŸ˜‚ğŸ¤·ğŸ»â€â™€ï¸	Neutral	0.0
Ab Banda qasam kesy khaye ğŸ˜Ÿ	Neutral	0.0
ğŸ˜‚ğŸ˜‚ğŸ˜‚ğŸ˜‚ğŸ˜‚ğŸ˜‚ğŸ˜‚ğŸ˜‚ğŸ˜‚Astgfirrullah 1 bt btao agr ab b promotion hui kis base py hogi	Neutral	0.0
South Punjab main Mostly Subha hotay hain to kuch log sirf fruits bhi detay hain. Per ab log shaam main bhi karnay lagay hain ku k subha log kam aatay hain	Neutral	0.0
Hahahahaha.... W8ing for Deba's come back... Ab Deba ki bari ha ğŸ˜‚ğŸ˜‚	Neutral	0.0
Bs karo ab yeh flirtabazzi wala Bavasseer kuch Aur start kar lo newğŸ˜¬ğŸ˜¤ğŸ˜¤	Neutral	0.0
Choerin jo b tha ab kia faida btaany ka ab to end hogiaaaağŸ˜‚ğŸ˜­	Neutral	0.0
Ab mtlb tmhi pta b nh hoga Twitter space jaha sb speaker par bat krty ğŸ‘ğŸ»ğŸ’¯	Neutral	0.0
Janab army ki wardi ka rawaj ab say nahi aya hazrat UMAR R. A kay dour sy hay	Neutral	0.0
Chalo Koi nahi Ab mujhy add na kerna BhaiğŸ˜…	Neutral	0.0
Ab ap mazaq kar rehe ho mere sath	Neutral	0.0
Ab to mujhe kuch kahin me tujhe batyoun ga	Neutral	0.0
agar mujhy aik acha Gaming/Graphical PC or free Internet mil jaye me Apny Dreams pory kr skta hu & Apni Basti ki ghurbat ko mita skta hu q k mene kamoyabi ko kafi qareeb se dekha he but ab kuch nahi bachağŸ˜”ğŸ˜”ğŸ˜”.....sirf chand ropy kamany kğŸ˜”	Neutral	0.0
same but 1.5 saal se haar hi raha hu....Computer tak kharab ho gaya na sell ho raha he na kuch....mazeed support bhi nahi ab family ki bs 2nd year k exams de k earning hi karni he....university ka dream bhi pora nahi ho sktağŸ˜”	Neutral	0.0
Ab itna to ap jantai hi hoğŸ˜ŠğŸ˜Š	Neutral	0.0
Milta hy abğŸ˜”â™¥ï¸	Neutral	0.0
Oops ğŸ˜¬ ISS kaa elaj to Hakeem luqmaan k paas bhi nhii hona ab Kia kryğŸ˜…	Neutral	0.0
Late ho gaya ab tak hire kar lia ho ga or thank u Hifza mujhe mention karny ke ley	Neutral	0.0
Kal deekh ke chupta tha Ab deekhta hain chup kar Vo dour tha bachpan ka Ye dour jawani hyğŸ¤ªğŸ¤«âœŒï¸	Neutral	0.0
RT : Itna bikhri hon is baar k ab kbhi smait nW sako gy tum :)	Neutral	0.0
Yeh sab tumhara karam hai Aqa Ke baat ab tak bani huyi hai	Neutral	0.0
RT : Asaan ab kia krain siwaye tumhay yaad krnay k xD	Neutral	0.0
Oho Allah Pak khair kary ga ameen	Neutral	0.0
kiya...? ab sa to apsa puchna praga ga kun ka ap....ğŸ¤£ğŸ¤£	Neutral	0.0
Berlin bulaye ga na hamain to yhi tea set use kregağŸ˜‚	Neutral	0.0
Awam ka zaati paisa hy kisi k baap ki Jageer nahi. Jo jiska dil kry ga zabht kr ly gy	Neutral	0.0
RT : Is trend ko follow kr ly kuch parhy likhy logo ka faida ho jay ga #savePhDs	Neutral	0.0
Koi nai usky wala kise r lifeline k sath chala jaye ga ğŸ¤£ğŸ¤£	Neutral	0.0
Result aye ga 3 se 5 seats	Neutral	0.0
Behna se nakhre toh keroon ga hi ğŸ¤­ğŸ¤­ğŸ¤­ğŸ¤­ğŸ¤­	Neutral	0.0
Agr hmain iss bat pe yakeen hai k Allah hmari duaen sunta hai to iss bat pe b yakeen hona chahiye k Allah unhn zror qabool kry ga.	Neutral	0.0
Aisay kaisay pehla student ho r wo fee na dy to start hi axha nai to khaak school chlay ga merağŸ™„ğŸ˜‚	Neutral	0.0
idr follow kardo ğŸ¤­ Fb mil jaye ga	Neutral	0.0
Tu rayan sun ly ga kuch...phir tu aesi hifazat kry ga na k kia btaun	Neutral	0.0
Mujhe baad main bhi nhi ho gağŸ˜‚	Neutral	0.0
RT : Basirpur m 29 june ko 11 bjy hatajag ho ga #27junelahoreprotest	Neutral	0.0
Alhamdullilah hame bhi parde ka khas khayal he or me bs itna kehna chahta tha k yaha per sab clear nai ho sakta he. Jaha tak clear hone ki baat he me ne neutral study ki he or dono ko suna he phir baat kr raha hu aap bhi aosa hi kijie phir sach pta chake ga	Neutral	0.0
Dil tera jado tutto ga fer pta challlu ga	Neutral	0.0
Han order krwa len gy ğŸ˜‚ghr se terha ho ka ae ga or koi hal ni hna phr phenky k ilawa kuch ni kr skain gyğŸ˜‚	Neutral	0.0
Courts main jna hunry liye bahut zzyda fidy mnd rah ga	Neutral	0.0
Ajye ga khi busy hoga	Neutral	0.0
Ar koi bi jurnalist govet ki ijazat ky bagair kissi American ambassador sy ni milly ga	Neutral	0.0
Pr ab koi kch ni kahy ga. Hmari dafa tou sb ki zuban chalti thi. ajeeb hypocrites	Neutral	0.0
Yehi to problem hai ab Ecat ke exams boards ke paper se pehle hain 5 july ko aur paper 12 july ko ğŸ˜­ğŸ˜­ğŸ˜­ ham entry test kre ya paper entry test na kia tu achi university ma admission nahi mille ga ğŸ˜¢ğŸ˜¢ #27junelahoreprotest #cancelExamSaveStudents	Neutral	0.0
Mam second installment of students of university can not be received till to date kia mily ge bhe ya wait and see ho ga	Neutral	0.0
parha kuch nhi yeahi likh kr aoun ga space kesy bnaty hainğŸ˜…ğŸ˜…ğŸ˜…	Neutral	0.0
Chl address tcs krwa de usi tsc wale k hath property bhejwa do ga ğŸ˜‚	Neutral	0.0
Kia protests se corona nai phely ga waha per bara sops ka khayal rakhna he aap ne. Dont be so ignorant and do hard work bcz in future there will be problems for you if exams are cancelled.	Neutral	0.0
Is tarhan ka ehtijaj ho ga thora wait krein.... Ye old vid hy..ğŸ™Œ	Neutral	0.0
Bat to theik hai pr Allah Rehman hai Rehm kry ga	Neutral	0.0
It's a web not a tv show so tv pr nhi mile ga ok i'll see to it kisi na kisi web site se shayad mil jaye	Neutral	0.0
Le ppl: Breakup hurts Idr se Pak Affairs ka sylybs phenk k maru ga na pora khandan parhta reh jaye ga	Neutral	0.0
zindgi ak khawab hy to ankhein band hyn jab khawab khatm ho jaye ga to idher ankhein band odher khool jayen g	Neutral	0.0
New 1st year ko, naa thek se cheating krni ati hai, na thek se proxy lagani ati hai, na he class mai late aney k koi suthrey bahaney atey hain... sb sekhaney parey ga mtlb sb .... smh	Neutral	0.0
Good place but I am not available for your but ap invite kry to zaroor ao ga	Neutral	0.0
"Eda shookha panğŸ¤£ Shadi k bad ""mujhy ghr jana hay"" wala status hu ga don't worry ğŸ¤—"	Neutral	0.0
ASSALAM O ALAIKUM respected sir g. Meri 8613 ki workshop reg gai h final semester ki autumn 2020 ki kindly help KR dain is ka kea solution ho ga ..please Bry e mehrbani guide KR dain.	Neutral	0.0
Paisa aa jayee toh me b Joy Baccarat Pure Parfum lon ga	Neutral	0.0
Tujhy mere pr yaqeen ni? Sara topic hi mera tha isne bs ye kaha tha k ye tweet kre ga bs	Neutral	0.0
mohtrma zra btayiye ga k shehbaz shareef aur nawaz sharef k hawaley se ap k kia khiyalat hain	Neutral	0.0
Phr yh document kahi maujood ho ga. Original ya iski copy maujood hogi ap k ps phr	Neutral	0.0
Someone is trying to report my account. Jisko Masla Hy bta do samne a k. Me Khud e delete krdoo ga. Yoo Chup k mehnat Q krtay ho Bhai	Neutral	0.0
Lock screen pr lga leta hn utth'tey he yh view dekh kr apko btaoun ga	Neutral	0.0
Ab qoute aye ga Still better than abdul wahan with a username malik hu yar who do nothing but a cheap photoshop ğŸ˜‚ stay tuned guys	Neutral	0.0
Aaj sir ne dobara tweet ki he k jald az jald upload ho jay ga result	Neutral	0.0
Aw ajye ga InshAllah tm krna start kro ğŸ’¯ğŸ˜â™¥ï¸	Neutral	0.0
Kal ker doon ga Asal ma Allah Hafiz ka tweet ker diya hai mane bhaiğŸ˜…	Neutral	0.0
Jab udhar au ga tab ğŸ˜	Neutral	0.0
Sochna pary ga	Neutral	0.0
Yar papers ke ley kuch kha dey. Itne follower's qabar main lete jay ga	Neutral	0.0
Treat de do warna sabko scheme bta du ga ğŸ¤¡	Neutral	0.0
Yr CA krna hy to prhna bi pry ga na	Neutral	0.0
Bs yr sochta hn is bar icap ka kia bny gağŸ˜‚	Neutral	0.0
Kindly follow back dain otherwise un follow kr dia jaye ga jazak Allah	Neutral	0.0
Cheetay se supplimentary budget aaye ga	Neutral	0.0
pubg install kr li hai sikhh bhi jaun ga	Neutral	0.0
Hahahahaha mujy bara maza ata hai in Indians k Jocks sun kr ğŸ¤£ğŸ˜‚ mujy lgta hai any Waly waqt mai #cartoon network khatam hi ho kr rah jay ga ğŸ˜‚	Neutral	0.0
"Jo classes days men ni parhta woh chuttion men bhi nahi parhta. ""Jo syllabus reh gea hy, chuttion men kar lon ga"" is the biggest scam."	Neutral	0.0
Bilkul jaisy ap kisi k le Kero gy waisa he ho ga	Neutral	0.0
Waise wo mujhy ignore ker raha hai Agr ignore kerna na choora toh wapis Maaz Ahmad simple rakh loon ga behnağŸ¥º	Neutral	0.0
Bhagna chor deya ha logon k pecha jisa ana ha akar rhy ga jisa jana ha rok nhi sakti tamasha ha daikh rhi hon Jo bhi hoga ab Khuda par chor rakha ha.......	Neutral	0.0
Abi tamatar jaida muh bna k bole ga main ne mana kiya tah nağŸ˜‚ğŸ˜‚ğŸ˜‚ğŸ˜‚ğŸ˜‚Allah	Neutral	0.0
Ab me in per amal kru ga by the way pen change kr k attemdance wala kaam me pehle se hi kr raha hu.ğŸ˜	Neutral	0.0
Ye corona Eid k time ata hai lekin 10 din baad bilkul khatam ğŸ˜ waise be is Eid k baad waise be corona nai aye ga ğŸ˜‚	Neutral	0.0
Chlain main krti aap rt kr day ga sahi hai?	Neutral	0.0
Its ur choice na koi compulsion nai ha â€¦ andar ka newton tang kry ga to qasoor mbbs ka to nai na huağŸ˜‚	Neutral	0.0
Friends k sath rahen. Na he alone hon ge aor na he yeh vicious cycle ho ga	Neutral	0.0
Chlain public survey krwain phr btaye ga mujheğŸ˜‚	Neutral	0.0
Ab kon bhulay ga, ab to idar line lag jaiygi girls ki ğŸ˜†ğŸ˜‰	Neutral	0.0
masak wali photo lgaon ga me v ab ğŸ˜‰	Neutral	0.0
Itna naik mshwra.apka zindagi bhar maskhoor rho ga	Neutral	0.0
Simple wording ma explain kare ga	Neutral	0.0
Ab risk tu lena pare ga nağŸ˜¶ğŸ‘‰ğŸ‘ˆ	Neutral	0.0
Humara Lahore kb final jeetay ga bhaiğŸ¥ºğŸ¥ºm ab ro dun gi	Neutral	0.0
Sab bhool jaye ga	Neutral	0.0
Jb seaview inka hai to inko to rakhna paray gağŸ˜‚	Neutral	0.0
Ab jo bhi cheez aa gayi pasand ya to jeeton ga ya mitt jaon ga	Neutral	0.0
Muhje bhi batao mei bhi 24/7 use karta ho onki baate sunke batao ga ğŸ˜‚	Neutral	0.0
Behan mn khud ignore hoti tmhy KayA karay ga	Neutral	0.0
Nai kal rat ko mein neibours ka ghar gai thi or Kaha tha anti kuj din ka lia apki choti beti ka nam udhar milay ga mein tweeter pa likhna # ajeeb	Neutral	0.0
Ma nhiii btao ga	Neutral	0.0
Bilkul.. Sub kuch kha liya.. Lekin behen ki chaye reh gayi... Host to bechara Sir pakar ker reh gaya hoo ga... ğŸ˜‚ğŸ˜œ	Neutral	0.0
Shm ko mere followers active hoty.. Tb du ga.. Don't worry..ğŸ™‰	Neutral	0.0
Are ap karlo follow nhi dega to mei oski I'd delete kardo ga	Neutral	0.0
Alhamdolillah mai bilkul thek ap btain kasi hain IETS exam to kb ka pass kr chuka hn Allah jany kb Australian borders open hon gy or mai jaa pawon ga	Neutral	0.0
Mein usman dekh raha houn last episode to use dekh kar bana lia. Ab wo kamyab ho ga. ğŸ¤£ğŸ˜‚	Neutral	0.0
Imran khan sy kaho America ka notice lay. america wesay he gayb ho Jaye ga	Neutral	0.0
Drama na dykhen pr novel zaroor parhen..... Guaranteed psnd aye ga	Neutral	0.0
Chly jay ga kam	Neutral	0.0
Baray walay pakro Jin ki tum sub perwarish kar rahy ho Maza to unki marnay maw aye ga	Neutral	0.0
Parna to phr bhee paray ga abb par rahy hain to papers bhee day datay hain ğŸ˜©ğŸ˜‘	Neutral	0.0
Us ny kaha tm na mili to mr jaon ga main.... Lykin kisi or pr... ğŸ˜’ğŸ˜’ğŸ˜’ğŸ˜’ #thuglife ğŸ¥€ğŸ¥€	Neutral	0.0
No one: People here: Adha name Urdu aur adha English me likh deta ho cool lagy ga.	Neutral	0.0
Ni ni parrots koi nhi khata nhi ktay ga ğŸ˜…ğŸ˜‚	Neutral	0.0
Sis nothing special only ma na Ap dono ka status dekhy Mean ap dono Naraz han So ma na ewen poch lia ka ap dono naraz han to phr mnae ga kon ap dono ko So shyd inhen meri bat buri lag gai ğŸ™„	Neutral	0.0
Koi Falak tk chalay ga sath meray?	Neutral	0.0
Main Aj K Baad Kbi Ni Pochoun Ga...ğŸ˜ğŸ˜ğŸ˜	Neutral	0.0
Yaar ab main apne bhai jese dost ke haqq pe daaka marta acha nhj lagun ga muazrat..	Neutral	0.0
Bro kiun k agr imad khely ga toh nawaz ko nhi khilayein gy	Neutral	0.0
univ main kon pakrey ga? ğŸ¤·â€â™‚ Attendance poori rakhni hoti hai bas woh hojati hai kaafi hai	Neutral	0.0
Phir Ahsaas program ya khareebo may distribute kr day savaab milay ga	Neutral	0.0
